Births,DHS Denominator,Deaths,Entered,Entered Rate,Establishment Exit,Exited,Exited Rate,Firm Exits.Count,Job Creation.Continuers,Job Creation.Count,Job Creation.Rate,Job Destruction,Job Destruction.Continuers,Job Destruction.Count,Job Destruction.Rate,Net Job Creation,Net Job Creation Rate,Number of Firms,Physical Locations,Rate/Births,Rate/Deaths,Reallocation Rate,State,Year
89869,933909,58891,10634,17.2,5641,8057,13.1,5623,101653,191522,20.5,36602,85855,144746,15.5,46776,5.0,52371,62852,9.6,6.3,31.0,Alabama,1977
19259,108134,13504,2028,27.0,1039,1564,20.8,1035,18286,37545,34.7,6757,25981,39485,36.5,-1940,-1.8,6480,7725,17.8,12.5,69.4,Alaska,1977
70645,589552,45366,9379,22.0,4357,6230,14.6,4332,76781,147426,25.0,29116,72063,117429,19.9,29997,5.1,36477,44113,12.0,7.7,39.8,Arizona,1977
44527,529709,32531,7291,18.3,3994,5455,13.7,3970,75201,119728,22.6,19678,44394,76925,14.5,42803,8.1,35499,40702,8.4,6.1,29.0,Arkansas,1977
779164,6484959,488562,88187,20.7,39932,60589,14.2,39693,960214,1739378,26.8,276475,594123,1082685,16.7,656693,10.1,362887,438766,12.0,7.5,33.4,California,1977
93270,786550,62313,12874,22.2,5694,8248,14.2,5673,104973,198243,25.2,37131,80745,143058,18.2,55185,7.0,51642,60187,11.9,7.9,36.4,Colorado,1977
69857,1059999,47273,9153,15.2,4263,6634,11.0,4248,144993,214850,20.3,24208,79955,127228,12.0,87622,8.3,53879,61410,6.6,4.5,24.0,Connecticut,1977
14260,220859,9058,1954,17.6,810,1250,11.2,807,20557,34817,15.8,5417,21206,30264,13.7,4553,2.1,9919,11465,6.5,4.1,27.4,Delaware,1977
27830,296031,20610,2262,15.2,1135,1855,12.5,1131,31594,59424,20.1,9899,37119,57729,19.5,1695,0.6,13027,15041,9.4,7.0,39.0,District of Columbia,1977
319998,2316656,191982,36816,20.7,19236,27045,15.2,19132,302876,622874,26.9,120706,226401,418383,18.1,204491,8.8,151970,182091,13.8,8.3,36.2,Florida,1977
146754,1452463,97339,17573,18.7,8911,13166,14.0,8877,173172,319926,22.0,56643,141751,239090,16.5,80836,5.5,78451,95914,10.1,6.7,33.0,Geogia,1977
27592,253382,19811,3306,19.0,1438,2150,12.4,1422,27993,55585,21.9,10556,20323,40134,15.8,15451,6.1,14785,17914,10.9,7.8,31.6,Hawaii,1977
24359,231419,15378,3729,20.5,1749,2500,13.7,1738,67757,92116,39.8,9788,21331,36709,15.9,55407,23.9,16105,18790,10.5,6.6,31.8,Idaho,1977
293000,3811704,202049,30780,15.2,16871,25527,12.6,16751,452823,745823,19.6,107141,328929,530978,13.9,214845,5.7,175560,204938,7.7,5.3,27.8,Illinois,1977
122035,1669441,81202,14426,15.4,7499,11454,12.2,7438,176792,298827,17.9,50182,139505,220707,13.2,78120,4.7,79024,95182,7.3,4.9,26.4,Indiana,1977
68130,809119,50775,10154,16.1,5295,7961,12.6,5274,100982,169112,20.9,31820,61101,111876,13.8,57236,7.1,54755,64042,8.4,6.3,27.6,Iowa,1977
86853,655567,44771,8534,16.7,4729,6944,13.6,4706,73081,159934,24.4,26825,58613,103384,15.8,56550,8.6,44466,51782,13.2,6.8,31.6,Kansas,1977
73635,885353,52001,9711,16.8,5226,7697,13.3,5214,119856,193491,21.9,31052,78707,130708,14.8,62783,7.1,50186,58576,8.3,5.9,29.6,Kentucky,1977
96403,992319,61750,11802,17.3,5852,8216,12.0,5819,126917,223320,22.5,37703,102161,163911,16.5,59409,6.0,58952,70029,9.7,6.2,33.0,Louisiana,1977
27020,283875,16956,3441,16.2,1762,2749,12.9,1756,32860,59880,21.1,9457,25579,42535,15.0,17345,6.1,18929,21673,9.5,6.0,30.0,Maine,1977
87380,1112672,65776,11007,16.4,5223,8105,12.0,5202,135360,222740,20.0,33840,129470,195246,17.5,27494,2.5,57557,68669,7.9,5.9,35.0,Maryland,1977
156633,1881581,104349,14690,13.7,7849,12039,11.2,7820,232821,389454,20.7,55353,147392,251741,13.4,137713,7.3,93706,108715,8.3,5.5,26.8,Massachusetts,1977
198770,2620761,129324,23171,16.0,11516,18173,12.6,11444,333924,532694,20.3,71034,208472,337796,12.9,194898,7.4,122826,147031,7.6,4.9,25.8,Michigan,1977
108577,1230894,73208,12235,16.2,5833,8977,11.9,5779,173802,282379,22.9,43594,105537,178745,14.5,103634,8.4,65489,76960,8.8,5.9,29.0,Minnesota,1977
48125,560084,34706,6881,17.2,3754,5252,13.1,3728,74685,122810,21.9,22449,46325,81031,14.5,41779,7.4,34771,40703,8.6,6.2,29.0,Mississippi,1977
113532,1469236,89617,15093,16.1,8321,12456,13.3,8281,183319,296851,20.2,47534,127491,217108,14.8,79743,5.4,79865,94772,7.7,6.1,29.6,Missouri,1977
23009,178501,13323,3670,20.0,1675,2397,13.1,1670,30799,53808,30.1,9899,15544,28867,16.2,24941,13.9,16633,18922,12.9,7.5,32.4,Montana,1977
38510,451602,29267,5742,16.2,2982,4374,12.3,2971,77529,116039,25.7,19346,43038,72305,16.0,43734,9.7,31391,36091,8.5,6.5,32.0,Nebraska,1977
24771,224173,15357,3258,23.1,1469,2044,14.5,1465,32400,57171,25.5,9485,19576,34933,15.6,22238,9.9,12872,14682,11.0,6.9,31.2,Nevada,1977
20146,253772,14599,3204,17.9,1407,2063,11.5,1400,31051,51197,20.2,8623,19898,34497,13.6,16700,6.6,16553,18449,7.9,5.8,27.2,New Hampshire,1977
178309,2258998,131558,20677,14.8,11057,17341,12.4,11014,249792,428101,19.0,63980,215066,346624,15.3,81477,3.7,124638,141637,7.9,5.8,30.6,New Jersey,1977
33274,266415,22137,4889,20.8,2429,3459,14.7,2421,33829,67103,25.2,13603,29360,51497,19.3,15606,5.9,20904,24176,12.5,8.3,38.6,New Mexico,1977
402075,5434966,323854,48067,13.7,31402,44902,12.8,31294,642565,1044640,19.2,181801,517757,841611,15.5,203029,3.7,312227,353279,7.4,6.0,31.0,New York,1977
132489,1719698,88097,16734,16.7,8412,12387,12.3,8384,174100,306589,17.8,51648,155901,243998,14.2,62591,3.6,84511,102521,7.7,5.1,28.4,North Carolina,1977
14237,146646,10832,2435,16.6,1175,1871,12.8,1170,15316,29553,20.2,7566,13588,24420,16.7,5133,3.5,13177,14917,9.7,7.4,33.4,North Dakota,1977
255150,3436627,171098,27571,14.8,13812,21859,11.7,13726,406990,662140,19.3,90134,280524,451622,13.1,210518,6.2,152029,189077,7.4,5.0,26.2,Ohio,1977
78333,721654,50346,10526,18.4,5652,7817,13.7,5626,86690,165023,22.9,32495,64986,115332,16.0,49691,6.9,50336,58471,10.9,7.0,32.0,Oklahoma,1977
71803,672087,50465,10970,20.9,4997,7492,14.3,4972,83830,155633,23.2,30325,57800,108265,16.1,47368,7.1,46565,54000,10.7,7.5,32.2,Oregon,1977
274187,3747564,183802,28483,13.8,14526,22690,11.0,14433,435878,710065,18.9,94367,320780,504582,13.5,205483,5.4,174493,208707,7.3,4.9,27.0,Pennsylvania,1977
18286,324421,14848,2770,14.4,1462,2227,11.6,1452,88028,106314,32.8,7106,24246,39094,12.1,67220,20.7,17573,19459,5.6,4.6,24.2,Rhode Island,1977
59698,827937,41938,8438,17.2,4229,6094,12.4,4204,77247,136945,16.5,23887,71989,113927,13.8,23018,2.7,42348,50173,7.2,5.1,27.6,South Carolina,1977
25862,171956,10499,2501,16.2,1255,2013,13.1,1255,45923,71785,41.7,6637,14577,25076,14.6,46709,27.1,13882,15605,15.0,6.1,29.2,South Dakota,1977
121560,1273560,74336,13760,17.9,6971,10117,13.2,6941,146050,267610,21.0,44016,114150,188486,14.8,79124,6.2,65615,78338,9.5,5.8,29.6,Tennessee,1977
434064,3845503,264045,49803,19.4,23750,34101,13.3,23575,506539,940603,24.5,157804,387859,651904,17.0,288699,7.5,214505,263754,11.3,6.9,34.0,Texas,1977
38733,339655,26057,5073,21.4,2167,3305,14.0,2147,53961,92694,27.3,15813,33276,59333,17.5,33361,9.8,21269,24554,11.4,7.7,35.0,Utah,1977
13726,139006,8799,1914,16.9,912,1347,11.9,909,17583,31309,22.5,4669,10387,19186,13.8,12123,8.7,10485,11609,9.9,6.3,27.6,Vermont,1977
127378,1360683,79434,14413,16.7,7027,10720,12.4,6985,155515,282893,20.8,42951,141854,221288,16.3,61605,4.5,72552,88154,9.4,5.8,32.6,Virginia,1977
112311,982351,65408,15570,20.7,6595,10117,13.4,6565,130401,242712,24.7,39509,86413,151821,15.5,90891,9.2,66226,77856,11.4,6.7,31.0,Washington,1977
41437,459237,31646,4779,15.7,2478,3800,12.5,2463,57153,98590,21.5,13568,41655,73301,16.0,25289,5.5,26551,30888,9.0,6.9,32.0,West Virginia,1977
96695,1401243,69944,13131,15.3,6269,9807,11.4,6219,142053,238748,17.0,38462,100721,170665,12.2,68083,4.8,75854,87660,6.9,5.0,24.4,Wisconsin,1977
15382,102991,8866,2260,21.9,928,1373,13.3,926,16116,31498,30.6,6309,10020,18886,18.3,12612,12.3,9659,10761,14.9,8.6,36.6,Wyoming,1977
72111,994708,55224,10260,16.0,5688,8002,12.5,5667,140955,213066,21.4,30942,82860,138084,13.9,74982,7.5,54168,65096,7.2,5.6,27.8,Alabama,1978
13069,108602,15082,1799,22.9,842,1484,18.9,837,22935,36004,33.2,6987,17715,32797,30.2,3207,3.0,6761,8010,12.0,13.9,60.4,Alaska,1978
60241,630226,56864,7743,17.8,4931,8348,19.2,4885,102764,163005,25.9,28307,50500,107364,17.0,55641,8.9,35147,43021,9.6,9.0,34.0,Arizona,1978
36140,556487,47659,5932,14.9,4434,7208,18.1,4419,71490,107630,19.3,21675,45551,93210,16.7,14420,2.6,33699,38928,6.5,8.6,33.4,Arkansas,1978
596335,7022464,528511,81007,18.2,41725,66905,15.0,41450,1085642,1681977,24.0,247948,714287,1242798,17.7,439179,6.3,375003,452620,8.5,7.5,35.4,California,1978
73365,843859,74935,10793,18.1,6740,11113,18.6,6706,139709,213074,25.2,38425,71853,146788,17.4,66286,7.8,50226,59213,8.7,8.9,34.8,Colorado,1978
52710,1121703,63706,8081,13.0,4308,6271,10.1,4291,140181,192891,17.2,32288,93069,156775,14.0,36116,3.2,55495,63208,4.7,5.7,28.0,Connecticut,1978
9385,223021,40838,1455,12.8,1232,1633,14.4,1231,49585,58970,26.4,34224,18267,59105,26.5,-135,-0.1,9701,11289,4.2,18.3,52.8,Delaware,1978
16796,307089,16725,1950,12.9,1138,1755,11.6,1122,45743,62539,20.4,8149,25337,42062,13.7,20477,6.7,13227,15244,5.5,5.4,27.4,District of Columbia,1978
241170,2491389,190812,35042,18.8,18967,26327,14.1,18883,379140,620310,24.9,110612,283435,474247,19.0,146063,5.9,159721,190761,9.7,7.7,38.0,Florida,1978
116387,1554502,93045,15577,16.0,8746,12529,12.9,8709,224365,340752,21.9,52218,124912,217957,14.0,122795,7.9,81041,98922,7.5,6.0,28.0,Geogia,1978
21978,268253,20138,2833,15.5,1419,2190,12.0,1405,34204,56182,20.9,7582,21735,41873,15.6,14309,5.3,15388,18557,8.2,7.5,31.2,Hawaii,1978
21739,243944,20769,3062,16.5,1921,3288,17.7,1912,33434,55173,22.6,9996,62509,83278,34.1,-28105,-11.5,15632,18330,8.9,8.5,45.2,Idaho,1978
219052,3997676,201422,27486,13.3,16528,23997,11.6,16387,492788,711840,17.8,98513,351351,552773,13.8,159067,4.0,178543,208502,5.5,5.0,27.6,Illinois,1978
90438,1768937,77489,13090,13.6,7361,10729,11.1,7320,237901,328339,18.6,40910,129139,206628,11.7,121711,6.9,81021,97478,5.1,4.4,23.4,Indiana,1978
54955,856849,41676,8988,13.9,5364,7426,11.5,5339,103997,158952,18.6,25468,78469,120145,14.0,38807,4.6,56025,65568,6.4,4.9,28.0,Iowa,1978
51261,691984,41566,7850,14.9,4430,6264,11.9,4417,88886,140147,20.3,23865,80166,121732,17.6,18415,2.7,45724,53325,7.4,6.0,35.2,Kansas,1978
60162,936461,60125,9082,15.3,5245,7408,12.5,5233,123672,183834,19.6,25056,83620,143745,15.3,40089,4.3,51398,60188,6.4,6.4,30.6,Kentucky,1978
74763,1062924,73187,9461,13.7,6371,10691,15.5,6345,178847,253610,23.9,36249,89276,162463,15.3,91147,8.6,56705,68048,7.0,6.9,30.6,Louisiana,1978
19027,297080,14471,3418,15.5,1812,2533,11.5,1807,43078,62105,20.9,8329,23223,37694,12.7,24411,8.2,19655,22500,6.4,4.9,25.4,Maine,1978
69148,1150318,62982,9599,13.8,5244,7874,11.3,5222,152175,221323,19.2,29272,108961,171943,14.9,49380,4.3,59019,70407,6.0,5.5,29.8,Maryland,1978
114895,2022855,110877,13209,12.1,7672,11451,10.4,7618,283687,398582,19.7,48507,142101,252978,12.5,145604,7.2,95418,110492,5.7,5.5,25.0,Massachusetts,1978
166774,2793463,138606,21107,14.2,11637,17433,11.7,11581,353036,519810,18.6,69164,195037,333643,11.9,186167,6.7,125933,150639,6.0,5.0,23.8,Michigan,1978
83671,1327630,67708,11114,14.2,5900,8496,10.9,5870,201749,285420,21.5,34237,127607,195315,14.7,90105,6.8,67767,79558,6.3,5.1,29.4,Minnesota,1978
42856,594424,33980,6185,15.1,3811,5694,13.9,3800,77178,120034,20.2,17983,59294,93274,15.7,26760,4.5,35073,41205,7.2,5.7,31.4,Mississippi,1978
99056,1550852,93361,14054,14.7,8297,12019,12.6,8268,211143,310199,20.0,40896,132939,226300,14.6,83899,5.4,81346,96711,6.4,6.0,29.2,Missouri,1978
16139,193375,19624,2890,15.5,1920,3267,17.5,1916,30577,46716,24.2,9760,20164,39788,20.6,6928,3.6,15956,18322,8.3,10.1,41.2,Montana,1978
30239,477295,33233,5004,13.7,2975,4157,11.4,2951,68111,98350,20.6,15148,56976,90209,18.9,8141,1.7,32033,36894,6.3,7.0,37.8,Nebraska,1978
25063,251213,23286,2841,19.5,1637,2875,19.7,1633,47739,72802,29.0,11388,15207,38493,15.3,34309,13.7,12572,14468,10.0,9.3,30.6,Nevada,1978
25241,278607,13161,3132,16.5,1534,2141,11.3,1528,40197,65438,23.5,7214,18843,32004,11.5,33434,12.0,17428,19426,9.1,4.7,23.0,New Hampshire,1978
137481,2348078,139931,19059,13.3,10816,16284,11.4,10775,307642,445123,19.0,58403,198386,338317,14.4,106806,4.6,127081,144463,5.9,6.0,28.8,New Jersey,1978
25533,282983,29780,3820,16.1,2719,4419,18.6,2715,48035,73568,26.0,17516,22834,52614,18.6,20954,7.4,19821,23243,9.0,10.5,37.2,New Mexico,1978
315152,5662022,353722,43751,12.4,30932,43379,12.3,30832,787689,1102841,19.5,172072,538174,891896,15.8,210945,3.7,313062,353760,5.6,6.2,31.6,New York,1978
108021,1799943,91530,15728,15.1,8562,12132,11.6,8526,217277,325298,18.1,43857,125137,216667,12.0,108631,6.1,87640,106079,6.0,5.1,24.0,North Carolina,1978
11304,156069,8124,2203,14.5,1193,1709,11.3,1189,22060,33364,21.4,5327,11377,19501,12.5,13863,8.9,13603,15383,7.2,5.2,25.0,North Dakota,1978
178168,3603082,163584,24430,12.8,13667,20672,10.8,13610,437396,615564,17.1,71255,321837,485421,13.5,130143,3.6,154897,192855,4.9,4.5,27.0,Ohio,1978
59579,759417,71350,8755,15.3,6360,10543,18.4,6344,103541,163120,21.5,36622,59711,131061,17.3,32059,4.2,47600,55988,7.8,9.4,34.6,Oklahoma,1978
69772,747631,52049,10748,19.4,5301,7828,14.1,5283,135725,205497,27.5,27853,48821,100870,13.5,104627,14.0,49114,56878,9.3,7.0,27.0,Oregon,1978
198829,3879649,235586,25306,12.0,14859,22355,10.6,14774,495614,694443,17.9,119050,380318,615904,15.9,78539,2.0,176944,211614,5.1,6.1,31.8,Pennsylvania,1978
20710,345722,18484,2499,12.7,1440,2088,10.6,1438,46932,67642,19.6,7988,73430,91914,26.6,-24272,-7.0,17892,19843,6.0,5.3,39.2,Rhode Island,1978
64901,875944,39626,8030,15.7,4403,6095,11.9,4392,108073,172974,19.7,18593,58398,98024,11.2,74950,8.5,43868,52112,7.4,4.5,22.4,South Carolina,1978
12789,182954,9076,2415,15.2,1306,1864,11.7,1305,24533,37322,20.4,5665,52051,61127,33.4,-23805,-13.0,14365,16130,7.0,5.0,40.8,South Dakota,1978
87492,1350566,78670,12067,15.2,6972,9967,12.6,6950,184052,271544,20.1,38450,120794,199464,14.8,72080,5.3,67459,80407,6.5,5.8,29.6,Tennessee,1978
326654,4089419,357495,40567,15.7,26702,46430,17.9,26558,630540,957194,23.4,174431,359133,716628,17.5,240566,5.9,204020,254416,8.0,8.7,35.0,Texas,1978
31944,365349,31018,4125,17.0,2410,4355,17.9,2401,53514,85458,23.4,14870,32015,63033,17.3,22425,6.1,20623,24015,8.7,8.5,34.6,Utah,1978
13881,151138,12244,1913,16.1,968,1288,10.8,961,22044,35925,23.8,4973,10856,23100,15.3,12825,8.5,11078,12226,9.2,8.1,30.6,Vermont,1978
93808,1433692,82262,13626,15.2,6907,10060,11.2,6880,192125,285933,19.9,42339,117538,199800,13.9,86133,6.0,75541,91681,6.5,5.7,27.8,Virginia,1978
104323,1113157,73594,15023,18.8,7057,11137,14.0,7033,225041,329364,29.6,40738,83313,156907,14.1,172457,15.5,69558,81677,9.4,6.6,28.2,Washington,1978
23609,462161,24020,4177,13.4,2484,3756,12.1,2478,48979,72588,15.7,11280,66095,90115,19.5,-17527,-3.8,26917,31297,5.1,5.2,31.4,West Virginia,1978
83921,1489387,67604,12536,14.0,6389,9124,10.2,6361,187243,271164,18.2,34761,91230,158834,10.7,112330,7.5,78852,91036,5.6,4.5,21.4,Wisconsin,1978
13906,116514,12265,1984,18.5,1180,1971,18.4,1178,23294,37200,31.9,6059,9251,21516,18.5,15684,13.4,9470,10634,11.9,10.5,37.0,Wyoming,1978
75192,1055982,64732,9436,14.4,5914,8106,12.4,5899,144164,219356,20.8,35731,100363,165095,15.6,54261,5.2,54730,65955,7.1,6.1,31.2,Alabama,1979
11685,108822,12091,1804,22.1,907,1400,17.2,904,17229,28914,26.6,5560,18707,30798,28.3,-1884,-1.7,7058,8298,10.7,11.1,53.2,Alaska,1979
75771,714182,31143,9229,20.1,132,3881,8.5,118,126007,201778,28.3,1452,62605,93748,13.1,108030,15.2,40325,48734,10.6,4.4,26.2,Arizona,1979
43304,583549,22603,6430,15.9,73,3658,9.0,66,70351,113655,19.5,2171,53062,75665,13.0,37990,6.5,36633,41977,7.4,3.9,26.0,Arkansas,1979
720477,7568239,475544,89981,19.3,42089,60626,13.0,41901,1136004,1856481,24.5,257452,699842,1175386,15.5,681095,9.0,397902,478672,9.5,6.3,31.0,California,1979
89746,932493,47808,12087,19.4,123,6051,9.7,106,145092,234838,25.2,3424,80305,128113,13.7,106725,11.5,56438,65644,9.6,5.1,27.4,Colorado,1979
62534,1174374,45613,7968,12.4,4167,6031,9.4,4160,136979,199513,17.0,21983,82334,127947,10.9,71566,6.1,56971,64839,5.3,3.9,21.8,Connecticut,1979
11430,213347,8172,1545,13.5,820,1203,10.5,809,19900,31330,14.7,3978,41317,49489,23.2,-18159,-8.5,9922,11562,5.4,3.8,29.4,Delaware,1979
14835,330425,15052,1872,12.2,1054,1607,10.5,1053,49643,64478,19.5,6545,22458,37510,11.4,26968,8.1,13368,15419,4.5,4.6,22.8,District of Columbia,1979
265284,2671506,182847,35973,18.4,18822,25357,13.0,18717,392538,657822,24.6,114510,249575,432422,16.2,225400,8.4,167423,200091,9.9,6.8,32.4,Florida,1979
125154,1656238,89695,15322,15.3,8797,12250,12.2,8777,202777,327931,19.8,46769,156278,245973,14.9,81958,4.9,82563,101415,7.6,5.4,29.8,Geogia,1979
24331,287811,15616,3148,16.5,1407,2052,10.8,1398,39866,64197,22.3,8575,25097,40713,14.1,23484,8.2,16172,19545,8.5,5.4,28.2,Hawaii,1979
48351,252502,11796,3259,17.0,34,1729,9.0,33,30394,78745,31.2,369,25955,37751,15.0,40994,16.2,17198,20007,19.1,4.7,30.0,Idaho,1979
235057,4163606,212717,26460,12.6,16242,23364,11.2,16189,515122,750179,18.0,99206,352399,565116,13.6,185063,4.4,179478,210329,5.6,5.1,27.2,Illinois,1979
94981,1858703,79536,12611,12.8,7599,10611,10.8,7566,211700,306681,16.5,41438,163990,243526,13.1,63155,3.4,81904,98946,5.1,4.3,26.2,Indiana,1979
52737,896269,45603,7941,12.1,5546,7600,11.6,5485,106113,158850,17.7,26839,70415,116018,12.9,42832,4.8,55826,65548,5.9,5.1,25.8,Iowa,1979
46496,722802,39881,7218,13.4,4460,6219,11.6,4448,98673,145169,20.1,22021,59225,99106,13.7,46063,6.4,46263,54040,6.4,5.5,27.4,Kansas,1979
67028,982930,51855,8596,14.1,5164,7006,11.5,5151,129226,196254,20.0,29037,88712,140567,14.3,55687,5.7,52229,61390,6.8,5.3,28.6,Kentucky,1979
89541,1165412,50712,11200,15.7,76,5514,7.8,57,171281,260822,22.4,1700,109185,159897,13.7,100925,8.7,62363,74231,7.7,4.4,27.4,Louisiana,1979
19386,312846,15106,3054,13.5,1850,2590,11.4,1844,34199,53585,17.1,8580,30445,45551,14.6,8034,2.5,19874,22803,6.2,4.8,29.2,Maine,1979
73270,1201420,65363,9756,13.7,5480,7883,11.1,5445,149293,222563,18.5,29949,101360,166723,13.9,55840,4.6,60029,71902,6.1,5.4,27.8,Maryland,1979
115994,2149249,88442,13252,11.9,7533,10914,9.8,7506,270818,386812,18.0,45723,186973,275415,12.8,111397,5.2,96906,112318,5.4,4.1,25.6,Massachusetts,1979
160823,2985065,126469,20204,13.3,11570,16678,11.0,11511,348988,509811,17.1,69149,226188,352657,11.8,157154,5.3,127979,153321,5.4,4.2,23.6,Michigan,1979
92124,1422387,66064,10829,13.4,5940,8499,10.6,5920,191843,283967,20.0,33403,117867,183931,12.9,100036,7.1,69373,81497,6.5,4.6,25.8,Minnesota,1979
45033,626893,34492,6614,15.8,3745,4992,11.9,3734,85413,130446,20.8,19545,56995,91487,14.6,38959,6.2,36186,42542,7.2,5.5,29.2,Mississippi,1979
94849,1635903,81578,13335,13.7,8040,11340,11.6,7979,211182,306031,18.7,43086,131858,213436,13.0,92595,5.7,82490,98170,5.8,5.0,26.0,Missouri,1979
19182,212784,8756,3324,17.3,20,1689,8.8,20,39029,58211,27.4,221,18893,27649,13.0,30562,14.4,17673,20098,9.0,4.1,26.0,Montana,1979
28082,490865,22789,4608,12.4,2802,4047,10.9,2796,64894,92976,18.9,12552,49513,72302,14.7,20674,4.2,32331,37234,5.7,4.6,29.4,Nebraska,1979
37943,295553,13059,3551,22.7,91,1366,8.7,90,52259,90202,30.5,842,24723,37782,12.8,52420,17.7,14667,16788,12.8,4.4,25.6,Nevada,1979
19477,307687,14011,2936,14.9,1583,2196,11.1,1577,43978,63455,20.6,7407,23817,37828,12.3,25627,8.3,17921,20047,6.3,4.6,24.6,New Hampshire,1979
150545,2452369,121555,19551,13.4,10322,15093,10.3,10295,298839,449384,18.3,56858,220483,342038,13.9,107346,4.4,130213,148059,6.1,5.0,27.8,New Jersey,1979
31773,311227,16743,4471,18.3,41,2309,9.5,36,46619,78392,25.2,832,28600,45343,14.6,33049,10.6,22016,25590,10.2,5.4,29.2,New Mexico,1979
316196,5829407,308833,43039,12.1,29064,39583,11.2,28950,701771,1017967,17.5,162524,570261,879094,15.1,138873,2.4,314425,355506,5.4,5.3,30.2,New York,1979
114582,1910551,85993,15066,14.0,8634,11909,11.1,8614,224295,338877,17.7,44753,135984,221977,11.6,116900,6.1,89357,108599,6.0,4.5,23.2,North Carolina,1979
14478,170166,9423,2263,14.5,1247,1731,11.1,1246,24693,39171,23.0,6591,14554,23977,14.1,15194,8.9,13973,15791,8.5,5.5,28.2,North Dakota,1979
198112,3750740,168034,23967,12.3,13400,20219,10.4,13348,426534,624646,16.7,74907,282961,450995,12.0,173651,4.7,156872,195658,5.3,4.5,24.0,Ohio,1979
71145,821971,36967,9984,17.0,98,4991,8.5,91,125153,196298,23.9,1235,70379,107346,13.1,88952,10.8,52568,61399,8.7,4.5,26.2,Oklahoma,1979
72124,834609,52923,10747,18.5,5688,7874,13.6,5680,140890,213014,25.5,30102,85222,138145,16.6,74869,8.9,51134,59275,8.6,6.3,33.2,Oregon,1979
188922,3960793,175270,24802,11.6,14461,21000,9.9,14390,449484,638406,16.1,78761,370324,545594,13.8,92812,2.3,178595,214372,4.8,4.4,27.6,Pennsylvania,1979
18715,337806,14341,2451,12.2,1342,1917,9.6,1340,39480,58195,17.2,7370,34711,49052,14.5,9143,2.7,18273,20277,5.5,4.2,29.0,Rhode Island,1979
51789,938815,38282,7374,14.0,4557,6155,11.7,4523,111783,163572,17.4,22195,76113,114395,12.2,49177,5.2,44350,53006,5.5,4.1,24.4,South Carolina,1979
14858,178064,9904,2257,13.9,1328,1868,11.5,1327,24609,39467,22.2,6139,14673,24577,13.8,14890,8.4,14557,16417,8.3,5.6,27.6,South Dakota,1979
96506,1421203,72814,11986,14.8,7199,10104,12.5,7187,178058,274564,19.3,38245,128412,201226,14.2,73338,5.1,68306,81771,6.8,5.1,28.4,Tennessee,1979
419040,4451203,199521,47590,17.7,381,22228,8.3,308,671394,1090434,24.5,9442,439461,638982,14.4,451452,10.1,228595,282055,9.4,4.5,28.8,Texas,1979
36997,395122,17691,4560,18.0,41,2025,8.0,37,54790,91787,23.2,650,38782,56473,14.3,35314,8.9,23101,26722,9.4,4.5,28.6,Utah,1979
10357,160819,8177,1753,14.1,1046,1360,11.0,1040,19877,30234,18.8,5397,15077,23254,14.5,6980,4.3,11344,12557,6.4,5.1,29.0,Vermont,1979
99825,1512843,73657,13106,14.1,7422,10377,11.2,7399,187755,287580,19.0,37383,137497,211154,14.0,76426,5.0,77100,93949,6.6,4.9,28.0,Virginia,1979
105212,1207327,98847,15324,18.3,7512,10892,13.0,7480,182586,287798,23.8,40436,167217,266064,22.0,21734,1.8,72969,85408,8.7,8.2,44.0,Washington,1979
28775,489740,20845,4349,13.8,2536,3581,11.3,2529,103521,132296,27.0,10888,36534,57379,11.7,74917,15.3,27284,31823,5.9,4.3,23.4,West Virginia,1979
82724,1583678,63667,11376,12.4,6463,9199,10.0,6444,177195,259919,16.4,33301,119411,183078,11.6,76841,4.8,80177,92794,5.2,4.0,23.2,Wisconsin,1979
15479,132024,6545,2227,19.7,26,1015,9.0,25,20374,35853,27.2,272,14736,21281,16.1,14572,11.1,10651,11919,11.7,5.0,32.2,Wyoming,1979
61121,1080875,58053,8630,13.1,6086,8426,12.8,6072,118247,179368,16.6,33755,121929,179982,16.7,-614,-0.1,54494,65852,5.7,5.4,33.2,Alabama,1980
8883,107880,7888,1477,17.8,892,1346,16.2,886,15370,24253,22.5,4606,15486,23374,21.7,879,0.8,7082,8324,8.2,7.3,43.4,Alaska,1980
72404,784645,48731,9389,18.8,4775,6662,13.3,4763,100541,172945,22.0,28763,88143,136874,17.4,36071,4.6,42362,51152,9.2,6.2,34.8,Arizona,1980
36084,610998,31904,5628,13.4,3981,5457,13.0,3971,76352,112436,18.4,17746,62413,94317,15.4,18119,3.0,36610,41952,5.9,5.2,30.8,Arkansas,1980
662641,8070425,509990,81844,16.8,44573,63887,13.1,44372,1061473,1724114,21.4,281515,869257,1379247,17.1,344867,4.3,411314,494149,8.2,6.3,34.2,California,1980
85392,1001872,72878,11825,17.7,6606,9311,14.0,6583,126037,211429,21.1,42218,99731,172609,17.2,38820,3.9,58297,67728,8.5,7.3,34.4,Colorado,1980
60611,1230114,47871,7590,11.6,4595,6535,10.0,4554,132484,193095,15.7,23569,100527,148398,12.1,44697,3.6,57616,65666,4.9,3.9,24.2,Connecticut,1980
11142,207446,9206,1342,11.6,912,1316,11.4,887,20340,31482,15.2,4646,15446,24652,11.9,6830,3.3,9956,11551,5.4,4.4,23.8,Delaware,1980
16839,349621,30166,1882,12.1,1099,1682,10.8,1095,59652,76491,21.9,7388,33780,63946,18.3,12545,3.6,13573,15600,4.8,8.6,36.6,District of Columbia,1980
281115,2876941,187917,36311,17.7,19564,26348,12.9,19499,373603,654718,22.8,116237,284735,472652,16.4,182066,6.4,175454,209305,9.8,6.5,32.8,Florida,1980
112458,1717525,94093,14144,13.9,8872,12510,12.3,8830,192161,304619,17.7,47751,169316,263409,15.3,41210,2.4,83538,102668,6.5,5.5,30.6,Geogia,1980
23490,301581,17011,3142,15.7,1474,2176,10.9,1460,31079,54569,18.1,9700,32141,49152,16.3,5417,1.8,16929,20433,7.8,5.6,32.6,Hawaii,1980
18415,260249,17393,3033,15.1,1967,2750,13.7,1959,30177,48592,18.7,9969,55959,73352,28.2,-24760,-9.5,17306,20154,7.1,6.7,37.4,Idaho,1980
214790,4218402,198851,24930,11.8,16526,23577,11.2,16441,370801,585591,13.9,94857,455441,654292,15.5,-68701,-1.6,179908,211082,5.1,4.7,27.8,Illinois,1980
93016,1861237,81446,11525,11.6,7676,10941,11.0,7641,158466,251482,13.5,39265,222909,304355,16.4,-52873,-2.9,81874,99140,5.0,4.4,27.0,Indiana,1980
49251,913100,48068,7611,11.6,5327,7178,10.9,5314,85855,135106,14.8,28356,91916,139984,15.3,-4878,-0.5,55749,65666,5.4,5.3,29.6,Iowa,1980
44071,749703,35525,6597,12.2,4543,6339,11.7,4532,79400,123471,16.5,22525,78121,113646,15.2,9825,1.3,46254,54081,5.9,4.7,30.4,Kansas,1980
54795,1007266,47030,7362,12.0,5372,7329,12.0,5356,101447,156242,15.5,27403,113943,160973,16.0,-4731,-0.5,51793,61174,5.4,4.7,31.0,Kentucky,1980
84660,1231262,67600,10607,14.1,6352,8772,11.7,6320,159466,244126,19.8,39622,142238,209838,17.0,34288,2.8,63552,75731,6.9,5.5,34.0,Louisiana,1980
16786,317362,16741,2758,12.1,1858,2668,11.7,1847,33210,49996,15.8,8536,30755,47496,15.0,2500,0.8,19757,22728,5.3,5.3,30.0,Maine,1980
102859,1264884,60600,9143,12.6,5452,8028,11.1,5417,149099,251958,19.9,31888,125727,186327,14.7,65631,5.2,60838,72838,8.1,4.8,29.4,Maryland,1980
108281,2239912,100621,12445,11.0,7569,11065,9.8,7517,265300,373581,16.7,48711,201806,302427,13.5,71154,3.2,97762,113338,4.8,4.5,27.0,Massachusetts,1980
145181,2970906,141696,18598,12.1,12059,17456,11.4,12019,230487,375668,12.6,67307,406278,547974,18.4,-172306,-5.8,127753,153767,4.9,4.8,25.2,Michigan,1980
83514,1484861,72388,9964,12.1,5982,8543,10.4,5943,160369,243883,16.4,39022,144696,217084,14.6,26799,1.8,70287,82646,5.6,4.9,29.2,Minnesota,1980
39621,645528,34540,5817,13.6,3796,5158,12.1,3773,65167,104788,16.2,19808,71603,106143,16.4,-1355,-0.2,36518,43031,6.1,5.4,32.4,Mississippi,1980
89912,1676529,84183,11971,12.2,8175,11547,11.8,8152,164443,254355,15.2,41837,177757,261940,15.6,-7585,-0.4,82350,98116,5.4,5.0,30.4,Missouri,1980
16849,223406,14751,2891,14.4,1876,2704,13.4,1870,21449,38298,17.1,9335,32629,47380,21.2,-9082,-4.1,17724,20141,7.5,6.6,34.2,Montana,1980
29239,506666,23285,4429,11.9,2984,4153,11.1,2975,56596,85835,16.9,14816,49632,72917,14.4,12918,2.5,32400,37353,5.8,4.6,28.8,Nebraska,1980
32628,329669,22960,3431,19.9,1801,2477,14.4,1794,45896,78524,23.8,16658,36336,59296,18.0,19228,5.8,15355,17631,9.9,7.0,36.0,Nevada,1980
18195,323960,17544,2553,12.7,1679,2334,11.6,1672,37087,55282,17.1,9597,30186,47730,14.7,7552,2.4,18005,20158,5.6,5.4,29.4,New Hampshire,1980
136458,2524700,118888,18191,12.2,10914,15533,10.4,10873,274374,410832,16.3,57552,253443,372331,14.7,38501,1.6,132229,150343,5.4,4.7,29.4,New Jersey,1980
29326,328117,24492,4234,16.4,2529,3553,13.8,2525,38310,67636,20.6,14673,40273,64765,19.7,2871,0.9,22407,26027,8.9,7.5,39.4,New Mexico,1980
314390,5918068,299762,40377,11.4,28890,39226,11.0,28818,653406,967796,16.4,158956,568567,868329,14.7,99467,1.7,314762,355779,5.3,5.1,29.4,New York,1980
100393,1988483,86634,13844,12.7,8926,12449,11.4,8888,195073,295466,14.9,49223,184617,271251,13.6,24215,1.3,89884,109519,5.0,4.4,27.2,North Carolina,1980
13115,180081,9864,2058,13.0,1279,1796,11.3,1278,20329,33444,18.6,6586,17715,27579,15.3,5865,3.3,14077,15978,7.3,5.5,30.6,North Dakota,1980
180440,3806420,163195,21720,11.1,13828,20491,10.5,13738,340587,521027,13.7,75324,414903,578098,15.2,-57071,-1.5,156831,196098,4.7,4.3,27.4,Ohio,1980
76640,885106,50024,9550,15.4,5909,7961,12.8,5882,112546,189186,21.4,30204,96008,146032,16.5,43154,4.9,53632,62673,8.7,5.7,33.0,Oklahoma,1980
67872,862988,56721,9942,16.6,6140,8601,14.4,6109,95373,163245,18.9,33179,122511,179232,20.8,-15987,-1.9,51986,60328,7.9,6.6,37.8,Oregon,1980
193932,4022847,187118,22704,10.6,15277,22079,10.3,15214,385279,579211,14.4,86745,370928,558046,13.9,21165,0.5,178026,214132,4.8,4.7,27.8,Pennsylvania,1980
15267,340926,13739,2176,10.7,1459,2090,10.3,1458,32633,47900,14.0,7406,34467,48206,14.1,-306,-0.1,18311,20297,4.5,4.0,28.0,Rhode Island,1980
52465,966684,42782,7169,13.4,4523,6323,11.9,4506,91681,144146,14.9,21057,93018,135800,14.0,8346,0.9,44827,53627,5.4,4.4,28.0,South Carolina,1980
13029,186117,10454,2057,12.5,1368,1861,11.3,1364,18112,31141,16.7,6774,19283,29737,16.0,1404,0.7,14648,16540,7.0,5.6,32.0,South Dakota,1980
85830,1445831,77243,11109,13.5,7251,10164,12.4,7236,139098,224928,15.6,39818,168614,245857,17.0,-20929,-1.4,68649,82403,5.9,5.3,31.2,Tennessee,1980
273070,4604289,325610,28147,10.5,30581,41043,15.3,30408,626014,899084,19.5,192868,496080,821690,17.8,77394,1.7,197706,252919,5.9,7.1,35.6,Texas,1980
32823,416219,27385,4206,15.7,2693,3808,14.2,2678,48597,81420,19.6,15608,44565,71950,17.3,9470,2.3,23139,26904,7.9,6.6,34.6,Utah,1980
9035,166906,7223,1652,13.1,1058,1397,11.0,1056,19898,28933,17.3,4549,16324,23547,14.1,5386,3.2,11514,12749,5.4,4.3,28.2,Vermont,1980
92235,1569964,70530,12450,13.2,7604,10822,11.4,7573,168273,260508,16.6,37651,148006,218536,13.9,41972,2.7,77942,95157,5.9,4.5,27.8,Virginia,1980
94134,1237123,75094,13661,15.9,8126,11661,13.5,8098,164374,258508,20.9,43343,140517,215611,17.4,42897,3.5,73976,86798,7.6,6.1,34.8,Washington,1980
26362,506848,24668,3750,11.8,2630,3669,11.5,2621,44796,71158,14.0,12632,86345,111013,21.9,-39855,-7.9,27159,31783,5.2,4.9,28.0,West Virginia,1980
72931,1618761,66087,10351,11.1,6781,9544,10.3,6749,139045,211976,13.1,35373,147356,213443,13.2,-1467,-0.1,80392,93227,4.5,4.1,26.2,Wisconsin,1980
13664,143298,9642,2084,17.2,1175,1608,13.3,1172,20635,34299,23.9,6648,15833,25475,17.8,8824,6.1,10947,12300,9.5,6.7,35.6,Wyoming,1980
71309,1049506,77850,7972,12.4,6081,9381,14.6,6056,102501,173810,16.6,37042,116628,194478,18.5,-20668,-1.9,52551,63502,6.8,7.4,33.2,Alabama,1981
11824,106881,8848,1480,17.9,750,1336,16.2,748,18584,30408,28.5,4444,11896,20744,19.4,9664,9.1,7104,8283,11.1,8.3,38.8,Alaska,1981
68460,797439,57838,8941,17.5,5257,8199,16.0,5241,95919,164379,20.6,30259,89514,147352,18.5,17027,2.1,42385,51310,8.6,7.3,37.0,Arizona,1981
44911,583058,37641,5424,13.3,4028,6144,15.0,4014,49793,94704,16.2,19401,70924,108565,18.6,-13861,-2.4,35019,40278,7.7,6.5,32.4,Arkansas,1981
694330,8205240,665325,76971,15.7,45863,77407,15.8,45626,1003049,1697379,20.7,290518,986368,1651693,20.1,45686,0.6,408274,488896,8.5,8.1,40.2,California,1981
100146,1017881,86744,11484,17.1,7037,11258,16.7,7006,133512,233658,23.0,45832,115902,202646,19.9,31012,3.1,57785,67245,9.8,8.5,39.8,Colorado,1981
70315,1240396,67779,7366,11.4,4744,8268,12.8,4738,108764,179079,14.4,25687,105623,173402,14.0,5677,0.4,56444,64151,5.7,5.5,28.0,Connecticut,1981
12208,211575,10737,1280,11.2,842,1488,13.1,839,19396,31604,14.9,4517,18108,28845,13.6,2759,1.3,9706,11249,5.8,5.1,27.2,Delaware,1981
25259,354941,50677,1781,11.6,1189,2198,14.4,1184,43395,68654,19.3,12545,29923,80600,22.7,-11946,-3.4,13115,15030,7.1,14.3,38.6,District of Columbia,1981
286356,3014820,234119,36207,17.2,20701,31440,14.9,20613,406880,693236,23.0,120653,336391,570510,18.9,122726,4.1,178244,212419,9.5,7.8,37.8,Florida,1981
131821,1720873,123359,13777,13.6,8869,14441,14.2,8847,191587,323408,18.8,48297,181331,304690,17.7,18718,1.1,81987,100899,7.7,7.2,35.4,Geogia,1981
27216,305274,20957,3000,14.7,1733,2850,14.0,1700,30590,57806,18.9,10583,31085,52042,17.0,5764,1.9,17073,20406,8.9,6.9,34.0,Hawaii,1981
36287,250145,18565,2667,13.6,2077,3213,16.4,2057,25111,61398,24.5,9980,29812,48377,19.3,13021,5.2,16460,19227,14.5,7.4,38.6,Idaho,1981
227322,4025498,262570,23382,11.3,16529,28369,13.7,16410,349516,576838,14.3,109079,438562,701132,17.4,-124294,-3.1,173447,203368,5.6,6.5,28.6,Illinois,1981
95769,1765454,106961,10378,10.7,7722,13009,13.4,7688,153063,248832,14.1,41752,191803,298764,16.9,-49932,-2.8,78583,95289,5.4,6.1,28.2,Indiana,1981
68295,872749,64448,7035,10.9,5338,8526,13.2,5316,65443,133738,15.3,25683,99691,164139,18.8,-30401,-3.5,53766,63474,7.8,7.4,30.6,Iowa,1981
55555,739441,47525,6710,12.6,4625,7473,14.0,4605,66156,121711,16.5,24088,77685,125210,16.9,-3499,-0.4,45126,52682,7.5,6.4,33.0,Kansas,1981
58431,944698,59346,6978,11.7,5119,8213,13.8,5102,87159,145590,15.4,26963,108747,168093,17.8,-22503,-2.4,49848,58912,6.2,6.3,30.8,Kentucky,1981
101116,1259344,82248,10629,14.1,6491,10254,13.6,6453,163285,264401,21.0,39080,136792,219040,17.4,45361,3.6,63310,75338,8.0,6.5,34.8,Louisiana,1981
17665,311506,20827,2611,11.7,1858,3003,13.5,1849,32882,50547,16.2,8441,29500,50327,16.2,220,0.0,19128,21998,5.7,6.7,32.4,Maine,1981
86602,1275299,85161,8897,12.3,5591,9797,13.6,5568,127592,214194,16.8,32202,157693,242854,19.0,-28660,-2.2,59739,71488,6.8,6.7,33.6,Maryland,1981
125367,2260249,156298,12150,10.8,7478,13281,11.8,7436,241852,367219,16.2,57603,213228,369526,16.3,-2307,-0.1,96214,111344,5.5,6.9,32.4,Massachusetts,1981
164571,2802878,184908,17059,11.3,12080,21384,14.2,12000,221266,385837,13.8,65260,326801,511709,18.3,-125872,-4.5,123243,147901,5.9,6.6,27.6,Michigan,1981
98844,1463405,97186,9428,11.6,5974,10300,12.6,5945,137842,236686,16.2,41864,156760,253946,17.4,-17260,-1.2,68780,80765,6.8,6.6,32.4,Minnesota,1981
36504,601942,36934,5057,12.0,3949,6053,14.4,3941,58281,94785,15.7,19855,67661,104595,17.4,-9810,-1.7,35092,41408,6.1,6.1,31.4,Mississippi,1981
102839,1622808,103489,11598,12.1,8151,13557,14.1,8124,156455,259294,16.0,41830,167229,270718,16.7,-11424,-0.7,79623,94775,6.3,6.4,32.0,Missouri,1981
15830,200481,17336,2734,14.0,1814,2907,14.8,1814,22158,37988,18.9,9491,22600,39936,19.9,-1948,-1.0,17112,19422,7.9,8.6,37.8,Montana,1981
33029,482591,31669,4092,11.4,2818,4785,13.3,2813,49386,82415,17.1,13933,47091,78760,16.3,3655,0.8,30846,35583,6.8,6.6,32.6,Nebraska,1981
30682,334726,28250,3230,18.3,1865,2985,16.9,1861,39723,70405,21.0,11907,46445,74695,22.3,-4290,-1.3,15347,17668,9.2,8.4,42.0,Nevada,1981
21577,317448,23154,2597,13.1,1639,2699,13.6,1636,36910,58487,18.4,8820,31499,54653,17.2,3834,1.2,17549,19671,6.8,7.3,34.4,New Hampshire,1981
164498,2514843,166423,17249,11.6,11404,19125,12.9,11362,265622,430120,17.1,58814,242552,408975,16.3,21145,0.8,129561,147107,6.5,6.6,32.6,New Jersey,1981
29721,325449,27636,3923,15.2,2639,4092,15.9,2629,40846,70567,21.7,15593,37925,65561,20.1,5006,1.6,22018,25535,9.1,8.5,40.2,New Mexico,1981
342525,5862840,403483,38945,11.1,28579,45640,13.0,28454,614439,956964,16.3,155841,607490,1010973,17.2,-54009,-0.9,307251,346538,5.8,6.9,32.6,New York,1981
116106,1966888,117400,13278,12.3,9091,14688,13.6,9063,181560,297666,15.1,49490,184865,302265,15.4,-4599,-0.3,87816,107193,5.9,6.0,30.2,North Carolina,1981
12930,170036,10886,1969,12.7,1253,2036,13.1,1252,15666,28596,16.8,6111,18681,29567,17.4,-971,-0.6,13541,15447,7.6,6.4,33.6,North Dakota,1981
188313,3615444,222057,20338,10.6,13973,25160,13.1,13901,273872,462185,12.8,77288,393632,615689,17.0,-153504,-4.2,151532,189344,5.2,6.1,25.6,Ohio,1981
79984,894851,65049,9586,15.4,6113,9200,14.8,6098,113722,193706,21.6,32564,85163,150212,16.8,43494,4.8,53266,62109,8.9,7.3,33.6,Oklahoma,1981
66356,812999,67923,9010,15.2,6168,9905,16.7,6146,70584,136940,16.8,34569,102140,170063,20.9,-33123,-4.1,50412,58527,8.2,8.4,33.6,Oregon,1981
230610,3985643,230928,20903,10.0,15409,26660,12.7,15340,345362,575972,14.5,89073,394983,625911,15.7,-49939,-1.2,170981,206089,5.8,5.8,29.0,Pennsylvania,1981
19112,337114,21114,2144,10.7,1484,2490,12.4,1480,30486,49598,14.7,8297,33873,54987,16.3,-5389,-1.6,17847,19791,5.7,6.3,29.4,Rhode Island,1981
57611,952226,58409,6773,12.8,4671,7641,14.5,4654,85175,142786,15.0,26123,89943,148352,15.6,-5566,-0.6,43447,52240,6.1,6.1,30.0,South Carolina,1981
11275,171563,11494,1762,11.0,1336,2150,13.4,1332,13817,25092,14.6,6566,18426,29920,17.4,-4828,-2.8,13981,15802,6.6,6.7,29.2,South Dakota,1981
87817,1403176,89695,10105,12.5,7445,11619,14.4,7416,138381,226198,16.1,41705,143562,233257,16.6,-7059,-0.5,66187,79665,6.3,6.4,32.2,Tennessee,1981
500349,4879338,310737,52884,19.5,19910,34927,12.9,19810,596194,1096543,22.5,130880,474916,785653,16.1,310890,6.4,235071,291027,10.3,6.4,32.2,Texas,1981
36675,416596,33316,4227,15.8,2654,4266,16.0,2642,43299,79974,19.2,16753,46667,79983,19.2,-9,0.0,22649,26560,8.8,8.0,38.4,Utah,1981
8699,161293,9323,1531,12.4,1061,1681,13.6,1057,16358,25057,15.5,5075,14641,23964,14.9,1093,0.6,11049,12252,5.4,5.8,29.8,Vermont,1981
120522,1586248,110576,12065,12.8,7805,13047,13.9,7757,166104,286626,18.1,46449,147232,257808,16.3,28818,1.8,76139,93322,7.6,7.0,32.6,Virginia,1981
97017,1222439,88570,12573,14.7,7920,13197,15.4,7886,133502,230519,18.9,41059,150063,238633,19.5,-8114,-0.6,72257,84939,7.9,7.2,37.8,Washington,1981
29683,471844,29224,3614,11.6,2787,4368,14.1,2784,40642,70325,14.9,13077,49880,79104,16.8,-8779,-1.9,26008,30615,6.3,6.2,29.8,West Virginia,1981
84137,1562754,83001,9715,10.6,6536,11341,12.4,6512,118949,203086,13.0,33536,171996,254997,16.3,-51911,-3.3,78256,90700,5.4,5.3,26.0,Wisconsin,1981
14592,149044,11469,2130,17.3,1232,1889,15.3,1229,22270,36862,24.7,6489,19170,30639,20.6,6223,4.1,11025,12419,9.8,7.7,41.2,Wyoming,1981
73771,1035586,62802,8770,13.8,4766,7905,12.4,4763,103713,177484,17.1,27015,121619,184421,17.8,-6937,-0.7,51528,63550,7.1,6.1,34.2,Alabama,1982
17287,118895,9822,2062,23.6,581,1113,12.7,578,23421,40708,34.2,5306,15681,25503,21.5,15205,12.7,7770,9202,14.5,8.3,43.0,Alaska,1982
97137,810479,56252,11014,20.8,3983,7184,13.5,3976,86571,183708,22.7,23401,112766,169018,20.9,14690,1.8,44307,54704,12.0,6.9,41.8,Arizona,1982
43730,574437,33088,6305,15.5,3059,5165,12.7,3055,56054,99784,17.4,16426,68029,101117,17.6,-1333,-0.2,34933,40902,7.6,5.8,34.8,Arkansas,1982
887957,8361841,528202,87529,17.5,34960,63168,12.7,34915,992557,1880514,22.5,231250,1052788,1580990,18.9,299524,3.6,416159,507962,10.6,6.3,37.8,California,1982
159697,1079447,76716,13933,20.1,5142,9428,13.6,5138,131126,290823,26.9,32193,120423,197139,18.3,93684,8.6,60030,71120,14.8,7.1,36.6,Colorado,1982
85654,1250950,51129,8917,13.7,3654,6249,9.6,3650,107789,193443,15.5,22434,125564,176693,14.1,16750,1.4,57543,66275,6.8,4.1,28.2,Connecticut,1982
13545,214437,8755,1583,13.9,658,1181,10.4,654,17065,30610,14.3,3178,18645,27400,12.8,3210,1.5,9918,11554,6.3,4.1,25.6,Delaware,1982
32202,337053,18749,2403,15.7,899,1738,11.3,895,28311,60513,18.0,7992,45698,64447,19.1,-3934,-1.1,13524,15582,9.6,5.6,36.0,District of Columbia,1982
330673,3106680,207785,41962,19.2,16557,27844,12.7,16531,351960,682633,22.0,107630,406812,614597,19.8,68036,2.2,185530,224964,10.6,6.7,39.6,Florida,1982
164650,1746660,98190,16197,15.8,6859,12492,12.2,6854,169922,334572,19.2,42263,196976,295166,16.9,39406,2.3,82630,103586,9.4,5.6,33.8,Geogia,1982
33667,311254,18882,3292,15.9,1355,2380,11.5,1355,26867,60534,19.4,8406,35855,54737,17.6,5797,1.8,17274,21094,10.8,6.1,35.2,Hawaii,1982
33498,249562,15771,3163,16.3,1410,2591,13.4,1409,19320,52818,21.2,7452,49931,65702,26.3,-12884,-5.1,16468,19544,13.4,6.3,42.4,Idaho,1982
289970,3926601,206379,28342,13.8,12830,22357,10.9,12810,317634,607604,15.5,79738,471106,677485,17.3,-69881,-1.8,174328,207478,7.4,5.3,31.0,Illinois,1982
104209,1722512,76137,12672,13.2,6046,10134,10.5,6026,133352,237561,13.8,33864,197304,273441,15.9,-35880,-2.1,78792,97057,6.0,4.4,27.6,Indiana,1982
65929,862235,45273,7812,12.4,4287,7275,11.5,4286,91084,157013,18.2,20707,99316,144589,16.8,12424,1.4,52350,62933,7.6,5.3,33.6,Iowa,1982
57443,741914,43734,7796,14.7,3748,6269,11.8,3726,74702,132145,17.8,22239,78239,121973,16.4,10172,1.4,45119,53521,7.7,5.9,32.8,Kansas,1982
76129,938637,47220,8804,14.8,4169,6926,11.6,4166,91109,167238,17.8,21752,107959,155179,16.5,12059,1.3,50098,60158,8.1,5.0,33.0,Kentucky,1982
115912,1297744,82782,13262,17.1,4939,8662,11.2,4922,161691,277603,21.4,38950,157381,240163,18.5,37440,2.9,65758,79316,8.9,6.4,37.0,Louisiana,1982
23931,312392,19425,3004,13.6,1451,2481,11.2,1444,29712,53643,17.2,9929,31236,50661,16.2,2982,1.0,19071,22254,7.7,6.2,32.4,Maine,1982
104776,1269528,64953,10849,14.9,4266,7703,10.6,4264,122608,227384,17.9,26947,144246,209199,16.5,18185,1.4,60832,74008,8.3,5.1,33.0,Maryland,1982
151188,2299675,93675,15237,13.4,5956,10541,9.3,5950,213405,364593,15.9,41290,219652,313327,13.6,51266,2.3,98088,115290,6.6,4.1,27.2,Massachusetts,1982
164916,2686353,146863,20280,13.6,9227,16693,11.2,9214,214389,379305,14.1,55876,334639,481502,17.9,-102197,-3.8,122650,150153,6.1,5.5,28.2,Michigan,1982
96515,1443395,69733,10889,13.4,4811,8522,10.5,4801,131025,227540,15.8,28508,176255,245988,17.0,-18448,-1.2,68678,82181,6.7,4.8,31.6,Minnesota,1982
41851,589624,33064,5936,14.3,2959,5006,12.1,2957,46227,88078,14.9,14331,66704,99768,16.9,-11690,-2.0,34671,41638,7.1,5.6,29.8,Mississippi,1982
155239,1633451,86411,13306,14.0,6540,11294,11.9,6521,149190,304429,18.6,37397,172703,259114,15.9,45315,2.7,78840,95517,9.5,5.3,31.8,Missouri,1982
20141,198950,13653,3054,15.6,1436,2501,12.8,1433,20980,41121,20.7,8010,26328,39981,20.1,1140,0.6,17059,19628,10.1,6.9,40.2,Montana,1982
34441,480356,24957,4735,13.3,2351,3890,10.9,2348,40574,75015,15.6,12182,54627,79584,16.6,-4569,-1.0,30581,35790,7.2,5.2,31.2,Nebraska,1982
38523,335154,23504,3692,20.3,1406,2505,13.8,1405,38090,76613,22.9,10635,46812,70316,21.0,6297,1.9,15935,18664,11.5,7.0,42.0,Nevada,1982
22836,326759,16782,3047,15.2,1281,2178,10.9,1280,31526,54362,16.6,8359,31062,47844,14.6,6518,2.0,17903,20303,7.0,5.1,29.2,New Hampshire,1982
176682,2548151,140613,20644,13.8,8820,15539,10.4,8811,280019,456701,17.9,50131,266020,406633,16.0,50068,1.9,131665,151014,6.9,5.5,32.0,New Jersey,1982
33842,334673,23111,4549,17.4,1887,3231,12.4,1887,39472,73314,21.9,11252,38615,61726,18.4,11588,3.5,22552,26589,10.1,6.9,36.8,New Mexico,1982
426999,5902562,296624,46816,13.4,22112,36881,10.5,22083,592132,1019131,17.3,130311,585159,881783,14.9,137348,2.4,310148,353411,7.2,5.0,29.8,New York,1982
141191,1968928,90994,15526,14.3,7305,11811,10.9,7290,163356,304547,15.5,39094,195563,286557,14.6,17990,0.9,88660,109820,7.2,4.6,29.2,North Carolina,1982
13945,171412,8775,2209,14.2,984,1713,11.0,983,17298,31243,18.2,5189,17279,26054,15.2,5189,3.0,13516,15679,8.1,5.1,30.4,North Dakota,1982
225909,3506120,164297,24446,12.8,10930,20170,10.6,10913,290388,516297,14.7,66014,410156,574453,16.4,-58156,-1.7,150716,191602,6.4,4.7,29.4,Ohio,1982
97440,947988,57888,12114,18.9,4623,7613,11.9,4621,126243,223683,23.6,28930,103160,161048,17.0,62635,6.6,55975,66082,10.3,6.1,34.0,Oklahoma,1982
75413,784462,56122,9608,16.4,4970,8931,15.3,4952,77310,152723,19.5,27160,113668,169790,21.6,-17067,-2.1,49241,58378,9.6,7.2,39.0,Oregon,1982
255840,3945137,185545,26202,12.6,11502,20407,9.8,11471,358865,614705,15.6,71537,446699,632244,16.0,-17539,-0.4,170926,209563,6.5,4.7,31.2,Pennsylvania,1982
20312,331141,15246,2462,12.4,1206,2061,10.3,1205,26895,47207,14.3,7347,36363,51609,15.6,-4402,-1.3,17894,20031,6.1,4.6,28.6,Rhode Island,1982
74337,922082,44066,8233,15.5,3776,6102,11.5,3772,77914,152251,16.5,23598,101629,145695,15.8,6556,0.7,43950,53821,8.1,4.8,31.6,South Carolina,1982
13079,167378,9235,1951,12.4,1051,1742,11.1,1050,14303,27382,16.4,5099,18354,27589,16.5,-207,-0.1,13678,15664,7.8,5.5,32.8,South Dakota,1982
110897,1394634,71588,12316,15.3,5825,9901,12.3,5818,118238,229135,16.4,34291,166400,237988,17.1,-8853,-0.7,66172,81133,8.0,5.1,32.8,Tennessee,1982
582424,5202200,315634,58523,19.4,20292,34608,11.5,20275,675553,1257977,24.2,141169,586736,902370,17.3,355607,6.9,247519,312446,11.2,6.1,34.6,Texas,1982
38779,420674,26666,4842,17.9,1980,3523,13.0,1980,45661,84440,20.1,13106,48792,75458,17.9,8982,2.2,22985,27573,9.2,6.3,35.8,Utah,1982
10823,162040,9014,1891,15.2,803,1340,10.8,790,15092,25915,16.0,4287,15961,24975,15.4,940,0.6,11298,12644,6.7,5.6,30.8,Vermont,1982
120466,1614790,80069,14270,15.1,6053,10560,11.1,6049,176266,296732,18.4,35442,193550,273619,16.9,23113,1.5,76933,96007,7.5,5.0,33.8,Virginia,1982
110239,1210293,72311,14841,17.2,6158,10965,12.7,6136,113466,223705,18.5,34735,165530,237841,19.7,-14136,-1.2,73192,87671,9.1,6.0,37.0,Washington,1982
33940,464766,27910,4211,13.8,2185,3816,12.5,2184,41867,75807,16.3,12243,50929,78839,17.0,-3032,-0.7,25339,30396,7.3,6.0,32.6,West Virginia,1982
102851,1533863,65090,11980,13.1,5373,9241,10.1,5364,122403,225254,14.7,28417,158276,223366,14.6,1888,0.1,78176,92160,6.7,4.2,29.2,Wisconsin,1982
23952,156246,10923,2489,19.5,981,1681,13.2,981,18639,42591,27.3,5404,22516,33439,21.4,9152,5.9,11398,13087,15.3,7.0,42.8,Wyoming,1982
68404,1008350,63721,7818,12.2,4884,7383,11.5,4861,99914,168318,16.7,28672,124541,188262,18.7,-19944,-2.0,52559,64548,6.8,6.3,33.4,Alabama,1983
15783,128659,10660,2259,23.1,757,1221,12.5,757,19577,35360,27.5,4841,21451,32111,25.0,3249,2.5,8798,10380,12.3,8.3,50.0,Alaska,1983
80718,822756,53973,9435,16.9,4763,7192,12.9,4743,105070,185788,22.6,29774,109177,163150,19.8,22638,2.8,46545,57195,9.8,6.6,39.6,Arizona,1983
37684,570494,29320,5448,13.2,3361,4814,11.6,3353,56652,94336,16.5,16481,62140,91460,16.0,2876,0.5,35923,41871,6.6,5.1,32.0,Arkansas,1983
599820,8321084,564210,70793,13.8,40136,63438,12.4,39906,960712,1560532,18.8,249852,1283503,1847713,22.2,-287181,-3.4,426462,517992,7.2,6.8,37.6,California,1983
93647,1088757,72534,11852,16.4,6438,9693,13.4,6409,117553,211200,19.4,37759,189964,262498,24.1,-51298,-4.7,62282,73644,8.6,6.7,38.8,Colorado,1983
61693,1261708,52247,7543,11.2,4055,6203,9.2,4048,130402,192095,15.2,21376,136825,189072,15.0,3023,0.2,59291,68139,4.9,4.1,30.0,Connecticut,1983
13261,216723,10263,1439,12.3,715,1171,10.0,710,19629,32890,15.2,4373,21591,31854,14.7,1036,0.5,10295,11941,6.1,4.7,29.4,Delaware,1983
19080,347245,15441,2028,12.8,965,1581,10.0,963,58607,77687,22.4,6655,34482,49923,14.4,27764,8.0,14133,16174,5.5,4.4,28.8,District of Columbia,1983
274794,3139059,233193,36827,16.2,19900,31999,14.0,19819,353448,628242,20.0,117227,384472,617665,19.7,10577,0.3,190507,230989,8.8,7.4,39.4,Florida,1983
129884,1761597,99959,14892,14.1,7628,11578,11.0,7611,192752,322636,18.3,45682,205284,305243,17.3,17393,1.0,86232,107526,7.4,5.7,34.6,Geogia,1983
21579,313054,17948,2793,13.0,1514,2259,10.5,1493,31933,53512,17.1,9973,39843,57791,18.5,-4279,-1.4,17978,21839,6.9,5.7,34.2,Hawaii,1983
16777,235298,15055,2607,13.2,1611,2413,12.2,1604,24190,40967,17.4,8259,36157,51212,21.8,-10245,-4.4,16851,19897,7.1,6.4,34.8,Idaho,1983
202279,3800343,229375,22707,11.0,14109,25620,12.4,14010,325065,527344,13.9,86046,465990,695365,18.3,-168021,-4.4,171918,205087,5.3,6.0,27.8,Illinois,1983
74920,1656094,108794,9691,10.2,7108,13097,13.8,7057,144495,219415,13.2,41432,194011,302805,18.3,-83390,-5.1,74718,92676,4.5,6.6,26.4,Indiana,1983
51006,832149,51742,6400,10.1,4306,6389,10.1,4296,69451,120457,14.5,21445,132449,184191,22.1,-63734,-7.6,53389,63885,6.1,6.2,29.0,Iowa,1983
47699,724018,49222,6689,12.4,3987,5902,10.9,3966,64332,112031,15.5,20525,95748,144970,20.0,-32939,-4.5,46404,54762,6.6,6.8,31.0,Kansas,1983
55409,923725,52529,7339,12.1,4623,6809,11.2,4613,80831,136240,14.7,26748,123232,175761,19.0,-39521,-4.3,51207,61174,6.0,5.7,29.4,Kentucky,1983
86100,1260193,91104,10466,13.1,6452,9369,11.7,6431,125464,211564,16.8,46244,212483,303587,24.1,-92023,-7.3,67495,80869,6.8,7.2,33.6,Louisiana,1983
17911,316502,15757,2679,11.9,1478,2292,10.2,1475,30718,48629,15.4,7526,27780,43537,13.8,5092,1.6,19672,22809,5.7,5.0,27.6,Maine,1983
73410,1287630,65692,9547,12.7,4677,7238,9.6,4650,138944,212354,16.5,28239,133730,199422,15.5,12932,1.0,63676,76930,5.7,5.1,31.0,Maryland,1983
123386,2331911,99420,12775,10.9,6921,10533,9.0,6891,223427,346813,14.9,46491,237775,337195,14.5,9618,0.4,100925,118300,5.3,4.3,29.0,Massachusetts,1983
132359,2630357,122734,17284,11.4,9780,15652,10.3,9722,236040,368399,14.0,55747,280661,403395,15.3,-34996,-1.3,125642,153082,5.0,4.7,28.0,Michigan,1983
82139,1414329,69319,9302,11.2,5123,8050,9.7,5104,132154,214293,15.2,31334,168897,238216,16.8,-23923,-1.6,70589,84129,5.8,4.9,30.4,Minnesota,1983
39222,574022,30367,5121,12.2,3279,4724,11.2,3262,54459,93681,16.3,16513,65681,96048,16.7,-2367,-0.4,35577,42476,6.8,5.3,32.6,Mississippi,1983
101147,1615228,94010,11785,12.2,6724,10396,10.8,6682,157050,258197,16.0,37811,215028,309038,19.1,-50841,-3.1,81397,97812,6.3,5.8,32.0,Missouri,1983
17462,196569,13198,2735,13.7,1531,2310,11.6,1516,20605,38067,19.4,8733,25683,38881,19.8,-814,-0.4,17739,20302,8.9,6.7,38.8,Montana,1983
32518,470496,26235,3923,10.8,2312,3578,9.9,2302,43011,75529,16.1,13286,54680,80915,17.2,-5386,-1.1,31505,36662,6.9,5.6,32.2,Nebraska,1983
26166,332451,21842,2837,15.1,1789,2678,14.3,1784,31213,57379,17.3,11403,47303,69145,20.8,-11766,-3.5,16170,18897,7.9,6.6,34.6,Nevada,1983
21021,332368,16168,2759,13.3,1399,2048,9.9,1397,36255,57276,17.2,8668,34190,50358,15.2,6918,2.0,18710,21156,6.3,4.9,30.4,New Hampshire,1983
156990,2592664,146793,18127,11.8,9916,15163,9.9,9895,288766,445756,17.2,55193,268142,414935,16.0,30821,1.2,135767,155125,6.1,5.7,32.0,New Jersey,1983
31265,333916,24770,4074,15.0,2172,3327,12.3,2169,37286,68551,20.5,13358,45213,69983,21.0,-1432,-0.5,23525,27583,9.4,7.4,41.0,New Mexico,1983
317954,5966648,306263,41467,11.6,25565,36329,10.2,25487,643428,961382,16.1,144363,664794,971057,16.3,-9675,-0.2,318787,362165,5.3,5.1,32.2,New York,1983
116714,1951673,110138,12413,11.5,8088,14724,13.6,8045,175550,292264,15.0,44571,199424,309562,15.9,-17298,-0.9,84963,106262,6.0,5.6,30.0,North Carolina,1983
11346,171271,11141,1812,11.4,1127,1696,10.7,1124,15731,27077,15.8,6348,19175,30316,17.7,-3239,-1.9,13888,16016,6.6,6.5,31.6,North Dakota,1983
167402,3429360,153146,19593,10.2,11777,19322,10.0,11696,298035,465437,13.6,67892,411735,564881,16.5,-99444,-2.9,153324,193626,4.9,4.5,27.2,Ohio,1983
73567,938901,67259,9261,13.9,6394,8770,13.2,6372,94545,168112,17.9,41004,157211,224470,23.9,-56358,-6.0,56795,66872,7.8,7.2,35.8,Oklahoma,1983
53820,756681,47430,8048,13.7,4991,7693,13.1,4962,79122,132942,17.6,26424,115189,162619,21.5,-29677,-3.9,50079,59185,7.1,6.3,35.2,Oregon,1983
199683,3858567,190734,21723,10.3,12399,20017,9.5,12337,335862,535545,13.9,73810,500872,691606,17.9,-156061,-4.0,175213,213454,5.2,4.9,27.8,Pennsylvania,1983
14197,330649,13866,2128,10.5,1296,1917,9.5,1294,32486,46683,14.1,6785,29839,43705,13.2,2978,0.9,18301,20378,4.3,4.2,26.4,Rhode Island,1983
53293,906297,52414,6290,11.9,4254,7249,13.7,4240,81214,134507,14.8,24142,101690,154104,17.0,-19597,-2.2,42225,52201,5.9,5.8,29.6,South Carolina,1983
10540,166127,9057,1719,10.9,1080,1687,10.7,1076,14746,25286,15.2,5293,17396,26453,15.9,-1167,-0.7,14024,15956,6.3,5.5,30.4,South Dakota,1983
99175,1390395,69097,10688,13.0,6359,9477,11.6,6328,146803,245978,17.7,36869,153105,222202,16.0,23776,1.7,68003,82972,7.1,5.0,32.0,Tennessee,1983
444880,5235620,359445,48407,15.3,27194,40083,12.6,26952,579938,1024818,19.6,183673,855968,1215413,23.2,-190595,-3.6,256749,322516,8.5,6.9,39.2,Texas,1983
34207,420041,25592,3739,13.4,2241,3502,12.6,2234,43264,77471,18.4,13967,55802,81394,19.4,-3923,-1.0,23460,28098,8.1,6.1,36.8,Utah,1983
8657,162155,6270,1585,12.4,904,1325,10.3,902,13587,22244,13.7,3849,17245,23515,14.5,-1271,-0.8,11688,13024,5.3,3.9,27.4,Vermont,1983
91007,1622507,76382,12244,12.5,6492,9888,10.1,6442,168440,259447,16.0,36726,188669,265051,16.3,-5604,-0.3,80067,99284,5.6,4.7,32.0,Virginia,1983
112306,1210142,66949,12758,14.3,6784,10543,11.8,6727,128245,240551,19.9,36932,153739,220688,18.2,19863,1.7,76292,90803,9.3,5.5,36.4,Washington,1983
25529,443563,25622,3385,11.1,2320,3516,11.5,2316,30037,55566,12.5,12624,72043,97665,22.0,-42099,-9.5,25750,30779,5.8,5.8,25.0,West Virginia,1983
71956,1514579,64074,9617,10.3,5461,8566,9.2,5439,126211,198167,13.1,31441,179640,243714,16.1,-45547,-3.0,80231,94261,4.8,4.2,26.2,Wisconsin,1983
12989,146464,12160,1855,14.2,1310,1917,14.6,1309,12468,25457,17.4,7754,37767,49927,34.1,-24470,-16.7,11467,13117,8.9,8.3,34.8,Wyoming,1983
74882,1040328,56023,10032,15.2,4910,7408,11.2,4888,139325,214207,20.6,28444,81542,137565,13.2,76642,7.4,55138,67233,7.2,5.4,26.4,Alabama,1984
16633,135862,10328,2456,22.6,902,1459,13.4,901,20813,37446,27.6,5761,16903,27231,20.0,10215,7.6,9721,11362,12.2,7.6,40.0,Alaska,1984
88592,886564,50448,10981,18.6,4652,7237,12.3,4630,142285,230877,26.0,27226,82130,132578,15.0,98299,11.0,49990,60964,10.0,5.7,30.0,Arizona,1984
42642,591885,30823,6764,15.8,3379,4944,11.6,3360,77121,119763,20.2,16933,44609,75432,12.7,44331,7.5,37626,43722,7.2,5.2,25.4,Arkansas,1984
683957,8501049,478894,81523,15.4,38462,61524,11.7,38298,1258455,1942412,22.8,232832,792115,1271009,15.0,671403,7.8,444670,537786,8.0,5.6,30.0,California,1984
101925,1095963,67139,13247,17.6,6496,9734,12.9,6474,143720,245645,22.4,35849,113158,180297,16.5,65348,5.9,65539,77255,9.3,6.1,33.0,Colorado,1984
74194,1292967,54138,8572,12.4,4197,6358,9.2,4186,149587,223781,17.3,24915,108090,162228,12.5,61553,4.8,61305,70362,5.7,4.2,25.0,Connecticut,1984
13713,223808,9639,1626,13.4,782,1297,10.7,779,26921,40634,18.2,3757,16884,26523,11.9,14111,6.3,10613,12270,6.1,4.3,23.8,Delaware,1984
19600,353491,18006,1873,11.7,1173,2071,12.9,1173,36809,56409,16.0,6855,51345,69351,19.6,-12942,-3.6,13793,15913,5.5,5.1,32.0,District of Columbia,1984
356722,3320817,197497,44838,18.8,19669,28709,12.0,19564,482898,839620,25.3,108460,296046,493543,14.9,346077,10.4,204982,247109,10.7,5.9,29.8,Florida,1984
142143,1852078,91212,17152,15.6,7556,11954,10.8,7527,247778,389921,21.1,45174,135443,226655,12.2,163266,8.9,90975,112875,7.7,4.9,24.4,Geogia,1984
18100,310797,17582,2526,11.6,1581,2523,11.6,1549,31053,49153,15.8,8836,31546,49128,15.8,25,0.0,17969,21828,5.8,5.7,31.6,Hawaii,1984
17990,239238,13559,2870,14.2,1565,2292,11.4,1562,34175,52165,21.8,8122,20832,34391,14.4,17774,7.4,17361,20481,7.5,5.7,28.8,Idaho,1984
237850,3851622,164385,27776,13.2,10338,19475,9.3,10288,472367,710217,18.4,52728,299581,463966,12.0,246251,6.4,180753,214659,6.2,4.3,24.0,Illinois,1984
110863,1684517,67623,12219,12.7,177,6396,6.6,154,205930,316793,18.8,1833,123948,191571,11.4,125222,7.4,82032,100417,6.6,4.0,22.8,Indiana,1984
51683,813190,37539,7685,11.9,4440,6643,10.3,4428,85343,137026,16.9,20054,72547,110086,13.5,26940,3.4,54248,64905,6.4,4.6,27.0,Iowa,1984
53604,742495,45527,7850,14.2,4165,7105,12.9,4155,119801,173405,23.4,22608,59281,104808,14.1,68597,9.3,47008,55572,7.2,6.1,28.2,Kansas,1984
61879,926022,48435,8716,14.1,4734,7019,11.3,4725,102755,164634,17.8,27193,74370,122805,13.3,41829,4.5,52680,62833,6.7,5.2,26.6,Kentucky,1984
89425,1226034,73874,11552,14.1,6629,9918,12.1,6603,140358,229783,18.7,36860,138054,211928,17.3,17855,1.4,68750,82544,7.3,6.0,34.6,Louisiana,1984
19436,327997,13102,3324,14.3,1452,2223,9.5,1444,37100,56536,17.2,6650,24009,37111,11.3,19425,5.9,20624,23857,5.9,4.0,22.6,Maine,1984
98263,1335248,70982,9621,12.5,5214,9056,11.7,5195,163700,261963,19.6,30943,100098,171080,12.8,90883,6.8,63699,77363,7.4,5.3,25.6,Maryland,1984
139131,2430899,91928,14760,12.3,6898,10642,8.8,6883,304485,443616,18.2,41653,186557,278485,11.5,165131,6.7,104727,122586,5.7,3.8,23.0,Massachusetts,1984
158996,2682072,126626,20564,13.2,9713,15346,9.8,9657,354422,513418,19.1,51279,171329,297955,11.1,215463,8.0,130947,158621,5.9,4.7,22.2,Michigan,1984
98644,1456843,70081,11483,13.4,5429,8475,9.9,5380,188139,286783,19.7,32224,109425,179506,12.3,107277,7.4,73463,87209,6.8,4.8,24.6,Minnesota,1984
41264,592868,30191,6232,14.4,3270,4867,11.3,3259,73916,115180,19.4,14956,43661,73852,12.5,41328,6.9,36901,43906,7.0,5.1,25.0,Mississippi,1984
111525,1652924,82694,13227,13.4,7280,11513,11.6,7251,201047,312572,18.9,42204,139910,222604,13.5,89968,5.4,83049,99775,6.7,5.0,27.0,Missouri,1984
15372,198664,11707,3215,15.5,1555,2377,11.5,1552,22766,38138,19.2,6989,21137,32844,16.5,5294,2.7,18551,21143,7.7,5.9,33.0,Montana,1984
29588,476473,27182,4242,11.6,2550,4368,11.9,2538,47733,77321,16.2,12842,45890,73072,15.3,4249,0.9,31279,36541,6.2,5.7,30.6,Nebraska,1984
28885,343825,20059,3528,18.1,1581,2413,12.4,1581,54468,83353,24.2,9125,27768,47827,13.9,35526,10.3,17171,20005,8.4,5.8,27.8,Nevada,1984
29749,350221,16317,3475,15.9,1431,2147,9.8,1426,50474,80223,22.9,7893,22467,38784,11.1,41439,11.8,19940,22503,8.5,4.7,22.2,New Hampshire,1984
179469,2680205,125343,20007,12.7,10026,15534,9.9,10004,330587,510056,19.0,54110,231012,356355,13.3,153701,5.7,139819,159770,6.7,4.7,26.6,New Jersey,1984
32475,343775,21059,4472,16.0,2366,3567,12.7,2361,43729,76204,22.2,12325,37149,58208,16.9,17996,5.3,24339,28441,9.4,6.1,33.8,New Mexico,1984
371141,6097225,286843,44945,12.3,26302,38364,10.5,26257,687512,1058653,17.4,161909,551347,838190,13.7,220463,3.7,325043,368867,6.1,4.7,27.4,New York,1984
127451,2037736,55613,17575,15.6,239,6616,5.9,230,260398,387849,19.0,1749,138184,193797,9.5,194052,9.5,97433,119472,6.3,2.7,19.0,North Carolina,1984
12192,172112,9896,2072,12.8,1057,1820,11.3,1054,17412,29604,17.2,5056,15344,25240,14.7,4364,2.5,14104,16305,7.1,5.7,29.4,North Dakota,1984
193324,3475636,135450,23392,11.9,11499,18807,9.6,11407,401571,594895,17.1,56969,271543,406993,11.7,187902,5.4,158035,198456,5.6,3.9,23.4,Ohio,1984
73247,914544,61449,10470,15.5,6219,8775,13.0,6210,99534,172781,18.9,33190,107864,169313,18.5,3468,0.4,58091,68485,8.0,6.7,37.0,Oklahoma,1984
56851,765430,41020,9596,15.9,4733,7060,11.7,4722,102598,159449,20.8,22430,70771,111791,14.6,47658,6.2,52482,61768,7.4,5.4,29.2,Oregon,1984
220049,3867472,175486,25281,11.7,12986,21212,9.8,12917,440985,661034,17.1,76271,307716,483202,12.5,177832,4.6,178940,217598,5.7,4.5,25.0,Pennsylvania,1984
19241,342904,13680,2511,12.2,1327,1985,9.6,1323,40335,59576,17.4,6390,26254,39934,11.6,19642,5.8,18812,20883,5.6,4.0,23.2,Rhode Island,1984
68034,939565,33218,8610,15.6,130,3834,7.0,127,111169,179203,19.1,1221,67759,100977,10.7,78226,8.4,47764,58091,7.2,3.5,21.4,South Carolina,1984
11763,170357,9635,2157,13.4,1069,1865,11.6,1067,20308,32071,18.8,4851,12847,22482,13.2,9589,5.6,14276,16261,6.9,5.7,26.4,South Dakota,1984
102570,1448024,72903,13068,15.4,6470,9755,11.5,6436,178353,280923,19.4,35131,124729,197632,13.6,83291,5.8,71061,86278,7.1,5.0,27.2,Tennessee,1984
499978,5266633,340019,52188,16.0,28024,42659,13.0,27900,667167,1167145,22.2,172149,583730,923749,17.5,243396,4.7,264132,331867,9.5,6.5,35.0,Texas,1984
33790,433613,23538,4423,15.5,2146,3364,11.8,2145,58089,91879,21.2,12195,37357,60895,14.0,30984,7.2,24402,29152,7.8,5.4,28.0,Utah,1984
11373,166945,7424,2007,15.0,901,1327,9.9,899,19018,30391,18.2,4290,10924,18348,11.0,12043,7.2,12300,13680,6.8,4.4,22.0,Vermont,1984
110148,1654170,97629,13549,13.7,7075,13608,13.8,7052,204156,314304,19.0,41773,118818,216447,13.1,97857,5.9,78723,98417,6.7,5.9,26.2,Virginia,1984
100305,1252889,67933,15169,16.3,6919,10501,11.3,6911,163470,263775,21.1,35792,125764,193697,15.5,70078,5.6,80717,95533,8.0,5.4,31.0,Washington,1984
25610,422005,30115,3698,12.2,2269,4520,14.9,2264,43944,69554,16.5,11559,34716,64831,15.4,4723,1.1,24683,29710,6.1,7.1,30.8,West Virginia,1984
89318,1538756,64385,11883,12.4,5824,9210,9.6,5804,182944,272262,17.7,28489,113524,177909,11.6,94353,6.1,82663,96931,5.8,4.2,23.2,Wisconsin,1984
13622,134617,10546,1921,14.6,1148,1840,14.0,1145,14505,28127,20.9,5522,17708,28254,21.0,-127,-0.1,11517,13197,10.1,7.8,41.8,Wyoming,1984
71006,1113206,62454,9620,14.1,5188,7859,11.5,5158,128462,199468,17.9,32391,99374,161828,14.5,37640,3.4,56904,69263,6.4,5.6,29.0,Alabama,1985
16780,149452,14139,2350,20.2,1180,1803,15.5,1175,24148,40928,27.4,6156,18386,32525,21.8,8403,5.6,10189,11923,11.2,9.5,43.6,Alaska,1985
96757,997245,69480,11646,18.5,5248,7977,12.7,5215,164248,261005,26.2,37122,90049,159529,16.0,101476,10.2,53291,64612,9.7,7.0,32.0,Arizona,1985
41362,650439,42064,6148,13.8,3725,5289,11.9,3690,71372,112734,17.3,21256,56489,98553,15.2,14181,2.1,38828,44972,6.4,6.5,30.4,Arkansas,1985
709752,9081292,619411,83652,15.3,40076,65019,11.9,39811,1214044,1923796,21.2,282553,948036,1567447,17.3,356349,3.9,463300,556699,7.8,6.8,34.6,California,1985
99309,1146241,85626,13226,16.9,7490,11071,14.1,7465,137286,236595,20.6,48116,119096,204722,17.9,31873,2.7,67414,79441,8.7,7.5,35.8,Colorado,1985
65510,1361371,64802,9007,12.6,4643,6959,9.7,4630,154344,219854,16.1,29287,105615,170417,12.5,49437,3.6,63242,72502,4.8,4.8,25.0,Connecticut,1985
13291,239484,11193,1744,13.9,770,1279,10.2,768,29433,42724,17.8,4629,19718,30911,12.9,11813,4.9,11023,12733,5.5,4.7,25.8,Delaware,1985
23434,355228,21232,1961,12.1,434,1472,9.1,423,42481,65915,18.6,6255,28859,50091,14.1,15824,4.5,14275,16470,6.6,6.0,28.2,District of Columbia,1985
339836,3602407,253410,44981,17.8,22110,32388,12.8,22027,477917,817753,22.7,139888,375367,628777,17.5,188976,5.2,215201,259414,9.4,7.0,35.0,Florida,1985
150247,2029062,109472,18304,15.8,7916,12568,10.8,7867,268751,418998,20.6,48801,170172,279644,13.8,139354,6.8,96305,118783,7.4,5.4,27.6,Geogia,1985
22258,316038,17168,2927,13.2,1476,2324,10.5,1464,33270,55528,17.6,7705,28233,45401,14.4,10127,3.2,18464,22379,7.0,5.4,28.8,Hawaii,1985
16149,251095,15343,2778,13.4,1640,2477,11.9,1631,27635,43784,17.4,9030,29731,45074,18.0,-1290,-0.6,17732,20897,6.4,6.1,34.8,Idaho,1985
237784,4066985,221356,26119,12.0,14800,23133,10.6,14716,418585,656369,16.1,98206,372486,593842,14.6,62527,1.5,184677,218917,5.8,5.4,29.2,Illinois,1985
108879,1798119,90397,12823,12.6,6827,10765,10.6,6795,173962,282841,15.7,43382,152528,242925,13.5,39916,2.2,84537,103018,6.1,5.0,27.0,Indiana,1985
42561,848464,48780,6627,10.2,4947,7423,11.5,4928,80383,122944,14.5,25370,70090,118870,14.0,4074,0.5,53774,64326,5.0,5.7,28.0,Iowa,1985
55539,791169,70358,7935,14.0,4134,6271,11.1,4116,80652,136191,17.2,25739,70249,140607,17.8,-4416,-0.6,48789,57371,7.0,8.9,34.4,Kansas,1985
60758,1017819,53039,8038,12.6,4816,7040,11.0,4787,108651,169409,16.6,26351,76916,129955,12.8,39454,3.8,54185,64346,6.0,5.2,25.6,Kentucky,1985
89005,1245248,81884,11200,13.5,6865,10257,12.3,6828,134603,223608,18.0,41109,139376,221260,17.8,2348,0.2,69542,83464,7.1,6.6,35.6,Louisiana,1985
22041,344999,22708,3486,14.2,1573,2480,10.1,1569,35422,57463,16.7,9282,29426,52134,15.1,5329,1.6,21796,25031,6.4,6.6,30.2,Maine,1985
108579,1432958,70737,11566,14.5,2387,6610,8.3,2356,188913,297492,20.8,22239,125030,195767,13.7,101725,7.1,68487,82601,7.6,4.9,27.4,Maryland,1985
134401,2563071,129460,15964,12.8,7560,11616,9.3,7531,306544,440945,17.2,61149,218811,348271,13.6,92674,3.6,108631,126964,5.2,5.1,27.2,Massachusetts,1985
205232,2853139,172498,20943,13.0,10639,16236,10.1,10581,317436,522668,18.3,64455,221346,393844,13.8,128824,4.5,135239,163398,7.2,6.0,27.6,Michigan,1985
105570,1558560,96843,11258,12.7,6229,9535,10.8,6197,171341,276911,17.8,53948,125325,222168,14.3,54743,3.5,75220,89172,6.8,6.2,28.6,Minnesota,1985
40183,652421,37079,5853,13.2,3476,5147,11.6,3459,67671,107854,16.5,18729,58588,95667,14.7,12187,1.8,37585,44765,6.2,5.7,29.4,Mississippi,1985
110782,1746317,109112,13853,13.6,7320,11055,10.9,7284,180517,291299,16.7,45636,140809,249921,14.3,41378,2.4,86028,103004,6.3,6.2,28.6,Missouri,1985
13882,218380,16080,2930,13.6,1820,2745,12.8,1817,21501,35383,16.2,8384,20930,37010,16.9,-1627,-0.7,19069,21604,6.4,7.4,32.4,Montana,1985
36522,503877,31576,4739,12.6,2611,3896,10.3,2600,47737,84259,16.7,16595,38562,70138,13.9,14121,2.8,32820,38078,7.2,6.3,27.8,Nebraska,1985
28701,369360,28174,3347,16.5,1896,2865,14.2,1891,44186,72887,19.7,13367,30265,58439,15.8,14448,3.9,17603,20476,7.8,7.6,31.6,Nevada,1985
27986,400410,23044,3935,16.7,1600,2410,10.3,1596,51048,79034,19.7,11110,34340,57384,14.3,21650,5.4,21587,24277,7.0,5.8,28.6,New Hampshire,1985
171396,2849019,154831,21816,13.4,10757,16267,10.0,10716,354730,526126,18.5,67457,257075,411906,14.5,114220,4.0,145125,165701,6.0,5.4,29.0,New Jersey,1985
30388,373694,29470,4372,15.2,2399,3717,12.9,2390,48960,79348,21.2,14315,35416,64886,17.4,14462,3.8,24968,29077,8.1,7.9,34.8,New Mexico,1985
342997,6318865,333782,47735,12.8,27278,39210,10.5,27169,699138,1042135,16.5,161653,529678,863460,13.7,178675,2.8,333438,378095,5.4,5.3,27.4,New York,1985
132590,2208228,100906,17424,14.3,8014,12491,10.2,7985,234279,366869,16.6,46028,188976,289882,13.1,76987,3.5,102134,124671,6.0,4.6,26.2,North Carolina,1985
11633,188080,9750,2057,12.3,1148,1784,10.7,1146,18233,29866,15.9,5569,16128,25878,13.8,3988,2.1,14661,16858,6.2,5.2,27.6,North Dakota,1985
176659,3617237,192293,23196,11.6,12496,20025,10.0,12393,422573,599232,16.6,85682,272783,465076,12.9,134156,3.7,161193,201446,4.9,5.3,25.8,Ohio,1985
65611,956124,62992,9748,14.1,6630,9449,13.7,6612,94507,160118,16.7,35246,99361,162353,17.0,-2235,-0.3,58653,69184,6.9,6.6,33.4,Oklahoma,1985
60129,822548,56705,9128,14.6,5498,8219,13.1,5457,98049,158178,19.2,30667,78761,135466,16.5,22712,2.7,53735,62941,7.3,6.9,33.0,Oregon,1985
216878,3992309,230383,26007,11.8,13722,22225,10.1,13621,398263,615141,15.4,114415,334873,565256,14.2,49885,1.2,182765,221542,5.4,5.8,28.4,Pennsylvania,1985
17115,356688,16810,2688,12.7,1437,2095,9.9,1436,37574,54689,15.3,10414,30744,47554,13.3,7135,2.0,19383,21512,4.8,4.7,26.6,Rhode Island,1985
67964,1012828,52802,8858,14.9,4146,6269,10.5,4133,114607,182571,18.0,26753,91688,144490,14.3,38081,3.7,50222,60919,6.7,5.2,28.6,South Carolina,1985
14062,189598,9331,2183,13.1,1109,1739,10.4,1103,17796,31858,16.8,5409,16259,25590,13.5,6268,3.3,14861,16857,7.4,4.9,27.0,South Dakota,1985
96778,1541644,81419,12390,14.1,6551,9892,11.3,6499,170238,267016,17.3,36716,126442,207861,13.5,59155,3.8,73597,89144,6.3,5.3,27.0,Tennessee,1985
471006,5484012,372071,53231,15.8,27037,41813,12.4,26856,669689,1140695,20.8,180343,598711,970782,17.7,169913,3.1,273940,343120,8.6,6.8,35.4,Texas,1985
32749,459964,27928,4424,15.0,2584,3954,13.4,2573,55421,88170,19.2,16124,41632,69560,15.1,18610,4.1,24879,29637,7.1,6.1,30.2,Utah,1985
11173,186234,10646,2121,14.9,975,1463,10.3,974,19057,30230,16.2,4559,14033,24679,13.3,5551,2.9,13196,14589,6.0,5.7,26.6,Vermont,1985
129207,1795831,71671,15583,15.0,341,6346,6.1,297,202702,331909,18.5,7925,152567,224238,12.5,107671,6.0,88347,108858,7.2,4.0,25.0,Virginia,1985
100367,1331499,84729,14324,14.8,7885,12187,12.6,7833,156972,257339,19.3,44795,132645,217374,16.3,39965,3.0,82898,97878,7.5,6.4,32.6,Washington,1985
29136,439735,16883,3885,12.6,139,2239,7.2,132,36995,66131,15.0,1293,40813,57696,13.1,8435,1.9,26913,31939,6.6,3.8,26.2,West Virginia,1985
82109,1593803,82211,11583,11.8,6466,9533,9.7,6416,153419,235528,14.8,40560,123061,205272,12.9,30256,1.9,84433,98765,5.2,5.2,25.8,Wisconsin,1985
10909,136316,10681,1863,14.1,1174,1810,13.7,1172,15228,26137,19.2,6200,15725,26406,19.4,-269,-0.2,11610,13269,8.0,7.8,38.4,Wyoming,1985
86524,1157441,61159,10412,14.8,5326,7918,11.3,5302,139901,226425,19.6,33580,110416,171575,14.8,54850,4.8,58637,71456,7.5,5.3,29.6,Alabama,1986
15613,150114,14050,2279,19.0,1314,2059,17.2,1314,18495,34108,22.7,7233,24755,38805,25.9,-4697,-3.2,10332,12056,10.4,9.4,45.4,Alaska,1986
115495,1074830,75347,12286,18.5,5795,8632,13.0,5788,145392,260887,24.3,41667,129808,205155,19.1,55732,5.2,56018,67984,10.7,7.0,38.2,Arizona,1986
50602,671833,37859,6172,13.6,3794,5405,11.9,3776,79937,130539,19.4,20445,62077,99936,14.9,30603,4.5,39347,45527,7.5,5.6,29.8,Arkansas,1986
830797,9425326,610238,92023,16.2,42884,68261,12.0,42785,1190829,2021626,21.4,298844,1051057,1661295,17.6,360331,3.8,481361,578182,8.8,6.5,35.2,California,1986
115574,1173451,93887,13382,16.7,7663,11491,14.3,7643,136429,252003,21.5,51905,132455,226342,19.3,25661,2.2,68458,80975,9.8,8.0,38.6,Colorado,1986
91312,1404785,64088,9977,13.5,4646,7109,9.6,4640,135669,226981,16.2,34398,124038,188126,13.4,38855,2.8,65664,75134,6.5,4.6,26.8,Connecticut,1986
34404,257420,12329,2016,15.4,794,1288,9.9,793,29291,63695,24.7,4447,24791,37120,14.4,26575,10.3,11624,13418,13.4,4.8,28.8,Delaware,1986
27713,381871,17574,2148,12.9,983,1643,9.8,980,38187,65900,17.3,7295,38967,56541,14.8,9359,2.5,14629,16930,7.3,4.6,29.6,District of Columbia,1986
378888,3787502,259818,47591,17.9,23310,34112,12.8,23278,486324,865212,22.8,147051,413772,673590,17.8,191622,5.0,225869,271892,10.0,6.9,35.6,Florida,1986
170234,2152526,126102,19719,16.2,8764,13765,11.3,8758,262060,432294,20.1,56258,195489,321591,14.9,110703,5.2,100749,124204,7.9,5.9,29.8,Geogia,1986
26290,331213,16007,3021,13.3,1500,2311,10.2,1500,40342,66632,20.1,7798,29907,45914,13.9,20718,6.2,18958,23003,7.9,4.8,27.8,Hawaii,1986
17495,252742,13408,2856,13.6,1560,2418,11.5,1555,28038,45533,18.0,8338,26561,39969,15.8,5564,2.2,18051,21219,6.9,5.3,31.6,Idaho,1986
271223,4152086,211964,27683,12.5,14169,22205,10.0,14131,429619,700842,16.9,98903,368962,580926,14.0,119916,2.9,188829,223773,6.5,5.1,28.0,Illinois,1986
122581,1844133,85854,13502,12.9,6886,10408,10.0,6855,182789,305370,16.6,45431,155498,241352,13.1,64018,3.5,86853,105751,6.6,4.7,26.2,Indiana,1986
56260,857244,44855,6866,10.7,4626,6962,10.9,4626,82260,138520,16.2,24197,76669,121524,14.2,16996,2.0,53517,63999,6.6,5.2,28.4,Iowa,1986
59344,796104,48099,7318,12.7,4753,6866,12.0,4727,81132,140476,17.6,24706,75434,123533,15.5,16943,2.1,48881,57567,7.5,6.0,31.0,Kansas,1986
71683,1057476,49447,8494,13.1,4731,6839,10.5,4717,109128,180811,17.1,27903,87790,137237,13.0,43574,4.1,55355,65776,6.8,4.7,26.0,Kentucky,1986
96930,1233080,83610,11060,13.3,7542,10891,13.1,7528,124875,221805,18.0,45764,160330,243940,19.8,-22135,-1.8,69072,83237,7.9,6.8,36.0,Louisiana,1986
25179,356264,19178,4015,15.6,1726,2640,10.3,1709,39923,65102,18.3,9632,29274,48452,13.6,16650,4.7,23017,26308,7.1,5.4,27.2,Maine,1986
127820,1523191,83779,13117,15.5,5320,8401,9.9,5197,188892,316712,20.8,38822,148104,231883,15.2,84829,5.6,72479,87147,8.4,5.5,30.4,Maryland,1986
181683,2641146,142391,17767,13.7,8108,12637,9.8,8085,294163,475846,18.0,67383,259314,401705,15.2,74141,2.8,112759,131643,6.9,5.4,30.4,Massachusetts,1986
203717,3003004,140287,21763,13.2,11304,17202,10.4,11282,346884,550601,18.3,71744,236673,376960,12.6,173641,5.7,138451,167450,6.8,4.7,25.2,Michigan,1986
103362,1602486,91613,11606,12.9,6221,9804,10.9,6194,180510,283872,17.7,47610,154493,246106,15.4,37766,2.3,76442,90673,6.5,5.7,30.8,Minnesota,1986
46289,672467,36656,6083,13.5,3287,4997,11.1,3274,83052,129341,19.2,19813,63404,100060,14.9,29281,4.3,38325,45637,6.9,5.5,29.8,Mississippi,1986
131510,1800448,93536,14609,13.9,6104,10330,9.8,6064,197214,328724,18.3,42371,164171,257707,14.3,71017,4.0,89489,107047,7.3,5.2,28.6,Missouri,1986
15503,216491,14722,2969,13.7,1922,2817,13.0,1920,20232,35735,16.5,9412,23360,38082,17.6,-2347,-1.1,19052,21621,7.2,6.8,33.0,Montana,1986
35585,514435,25002,4143,10.9,2585,3982,10.5,2578,45776,81361,15.8,13579,48912,73914,14.4,7447,1.4,32836,38099,6.9,4.9,28.8,Nebraska,1986
34843,385468,28565,3665,17.6,1918,2889,13.9,1917,46701,81544,21.2,14199,34285,62850,16.3,18694,4.9,18216,21170,9.0,7.4,32.6,Nevada,1986
37930,422210,28202,4736,18.7,1792,2648,10.5,1790,49968,87898,20.8,12060,37453,65655,15.6,22243,5.2,23372,26275,9.0,6.7,31.2,New Hampshire,1986
214193,2944309,160379,23678,14.1,11516,17618,10.5,11489,339494,553687,18.8,70144,309238,469617,15.9,84070,2.9,150356,171239,7.3,5.4,31.8,New Jersey,1986
35717,383272,23117,4741,16.1,2406,3714,12.6,2403,41346,77063,20.1,13860,46958,70075,18.3,6988,1.8,25598,29909,9.3,6.0,36.6,New Mexico,1986
415196,6499881,342601,50293,13.2,28407,41451,10.9,28325,714853,1130049,17.4,162731,599361,941962,14.5,188087,2.9,340644,385808,6.4,5.3,29.0,New York,1986
170998,2300094,108580,18767,14.7,8573,12976,10.2,8481,248008,419006,18.2,53039,196599,305179,13.3,113827,4.9,106573,129909,7.4,4.7,26.6,North Carolina,1986
11605,189562,9665,1876,11.1,1169,1772,10.5,1166,16396,28001,14.8,5941,19385,29050,15.3,-1049,-0.5,14663,16882,6.1,5.1,29.6,North Dakota,1986
230213,3727732,192791,24868,12.2,12651,19914,9.8,12613,384445,614658,16.5,108633,326593,519384,13.9,95274,2.6,164812,205807,6.2,5.2,27.8,Ohio,1986
73128,944842,68345,9345,13.6,6921,9841,14.3,6903,89397,162525,17.2,37329,112021,180366,19.1,-17841,-1.9,57575,68284,7.7,7.2,34.4,Oklahoma,1986
66569,844527,53650,9833,15.4,5230,7798,12.2,5225,93285,159854,18.9,30161,81606,135256,16.0,24598,2.9,55462,64798,7.9,6.4,32.0,Oregon,1986
276212,4076649,196904,29142,12.9,13456,21221,9.4,13423,413120,689332,16.9,99275,367870,564774,13.9,124558,3.0,189315,228738,6.8,4.8,27.8,Pennsylvania,1986
24409,369651,17355,3067,14.0,1439,2141,9.8,1435,40356,64765,17.5,10578,27272,44627,12.1,20138,5.4,20131,22348,6.6,4.7,24.2,Rhode Island,1986
75649,1044552,59137,9136,14.7,4253,6574,10.6,4250,113852,189501,18.1,26641,102460,161597,15.5,27904,2.6,52164,63180,7.2,5.7,31.0,South Carolina,1986
12482,193007,10640,1937,11.5,1116,1766,10.5,1115,17340,29822,15.5,6723,18745,29385,15.2,437,0.3,14950,16954,6.5,5.5,30.4,South Dakota,1986
115740,1603062,87650,13070,14.4,6703,10013,11.1,6690,183370,299110,18.7,47135,142084,229734,14.3,69376,4.4,75788,91817,7.2,5.5,28.6,Tennessee,1986
472714,5561133,400440,52914,15.3,31199,46156,13.4,31056,618866,1091580,19.6,211728,688319,1088759,19.6,2821,0.0,277741,348259,8.5,7.2,39.2,Texas,1986
43612,481290,31290,4564,15.3,2560,3935,13.2,2551,54473,98085,20.4,17844,53784,85074,17.7,13011,2.7,25259,30150,9.1,6.5,35.4,Utah,1986
13940,194338,9353,2338,15.7,1120,1623,10.9,1120,21445,35385,18.2,5725,14524,23877,12.3,11508,5.9,13768,15239,7.2,4.8,24.6,Vermont,1986
158225,1916697,89441,17105,15.3,7077,11114,10.0,7062,229204,387429,20.2,42478,158845,248286,13.0,139143,7.2,93021,114574,8.3,4.7,26.0,Virginia,1986
111590,1380402,89738,15705,15.8,7853,12161,12.2,7811,178770,290360,21.0,47218,140431,230169,16.7,60191,4.3,85622,100918,8.1,6.5,33.4,Washington,1986
37048,446056,33296,3996,12.5,2308,3654,11.4,2302,42092,79140,17.7,12429,41712,75008,16.8,4132,0.9,27209,32207,8.3,7.5,33.6,West Virginia,1986
91476,1599541,109118,10425,10.8,6949,12873,13.3,6914,153046,244522,15.3,42178,129004,238122,14.9,6400,0.4,80616,95092,5.7,6.8,29.8,Wisconsin,1986
10978,133664,10454,1668,12.7,1240,1844,14.0,1239,13955,24933,18.7,6534,17477,27931,20.9,-2998,-2.2,11366,13021,8.2,7.8,37.4,Wyoming,1986
85721,1200238,72345,11313,15.6,5603,8636,11.9,5560,130889,216610,18.0,33710,129048,201393,16.8,15217,1.2,60258,73813,7.1,6.0,33.6,Alabama,1987
12933,145006,16103,2014,16.9,1467,2281,19.2,1453,16079,29012,20.0,9133,23028,39131,27.0,-10119,-7.0,9909,11684,8.9,11.1,40.0,Alaska,1987
115527,1123696,97931,13545,19.4,6243,9662,13.8,6185,129757,245284,21.8,45399,127604,225535,20.1,19749,1.7,58318,71502,10.3,8.7,40.2,Arizona,1987
46580,699345,46595,6842,14.9,3977,5660,12.3,3946,73758,120338,17.2,26184,66988,113583,16.2,6755,1.0,39898,46468,6.7,6.7,32.4,Arkansas,1987
845682,9883744,787625,101130,17.1,47572,74324,12.6,47020,1294653,2140335,21.7,364454,1070030,1857655,18.8,282680,2.9,498637,601790,8.6,8.0,37.6,California,1987
110481,1179240,119082,13875,17.0,8086,12495,15.3,7987,119000,229481,19.5,57649,154588,273670,23.2,-44189,-3.7,68775,81912,9.4,10.1,39.0,Colorado,1987
92247,1459992,73950,11757,15.3,5306,7985,10.4,5283,161076,253323,17.4,36699,120289,194239,13.3,59084,4.1,68351,78649,6.3,5.1,26.6,Connecticut,1987
16706,272279,14583,2247,16.3,930,1478,10.7,928,35536,52242,19.2,5413,40657,55240,20.3,-2998,-1.1,12152,14145,6.1,5.4,38.4,Delaware,1987
24162,399585,20405,2205,12.9,1075,1898,11.1,1065,45559,69721,17.4,8846,32095,52500,13.1,17221,4.3,14828,17220,6.0,5.1,26.2,District of Columbia,1987
416100,3985126,320415,53022,19.0,25981,37431,13.4,25796,480635,896735,22.5,175329,441126,761541,19.1,135194,3.4,235617,286073,10.4,8.0,38.2,Florida,1987
202803,2265027,152591,21394,16.8,9794,15351,12.1,9720,257257,460060,20.3,67453,240674,393265,17.4,66795,2.9,104235,129764,9.0,6.7,34.8,Geogia,1987
30077,353282,24867,3522,15.0,1632,2593,11.1,1621,46264,76341,21.6,11021,34547,59414,16.8,16927,4.8,19499,23814,8.5,7.0,33.6,Hawaii,1987
20310,254619,20011,3168,14.8,1548,2637,12.3,1535,27258,47568,18.7,10497,29061,49072,19.3,-1504,-0.6,18375,21600,8.0,7.9,37.4,Idaho,1987
265263,4232605,274757,30933,13.7,15476,24886,11.0,15370,421816,687079,16.2,104806,418615,693372,16.4,-6293,-0.2,192023,228983,6.3,6.5,32.4,Illinois,1987
127028,1923141,110968,14915,13.9,7375,11508,10.7,7325,226917,353945,18.4,50562,168453,279421,14.5,74524,3.9,88834,108810,6.6,5.8,29.0,Indiana,1987
58643,879780,51190,7803,12.1,4539,7176,11.2,4486,85579,144222,16.4,24971,80659,131849,15.0,12373,1.4,53491,64363,6.7,5.8,30.0,Iowa,1987
59363,798343,83039,7698,13.3,4691,7132,12.3,4639,76428,135791,17.0,27901,78021,161060,20.2,-25269,-3.2,48907,57884,7.4,10.4,34.0,Kansas,1987
71549,1101927,67496,9376,14.1,4853,7611,11.4,4840,114455,186004,16.9,30040,95644,163140,14.8,22864,2.1,56376,67318,6.5,6.1,29.6,Kentucky,1987
90650,1193986,108828,10617,12.9,8193,12637,15.4,8110,114132,204782,17.2,52757,163589,272417,22.8,-67635,-5.6,66411,80651,7.6,9.1,34.4,Louisiana,1987
31734,380019,22532,4820,17.7,1918,2921,10.7,1912,43915,75649,19.9,10720,28680,51212,13.5,24437,6.4,24466,28132,8.4,5.9,27.0,Maine,1987
159196,1624802,94454,14470,16.2,6170,9703,10.8,6105,189855,349051,21.5,44401,161990,256444,15.8,92607,5.7,75607,91745,9.8,5.8,31.6,Maryland,1987
176577,2715234,161309,19834,14.8,9171,13913,10.3,9122,297398,473975,17.5,71481,274836,436145,16.1,37830,1.4,116844,137046,6.5,5.9,32.2,Massachusetts,1987
204900,3147301,171999,24903,14.6,11791,18161,10.6,11694,330709,535609,17.0,76827,304442,476441,15.1,59168,1.9,142587,173534,6.5,5.5,30.2,Michigan,1987
110229,1652382,113151,12695,13.8,6335,10134,11.0,6287,178600,288829,17.5,62679,147091,260242,15.7,28587,1.8,77712,92833,6.7,6.8,31.4,Minnesota,1987
47639,692385,42987,6560,14.3,3746,5563,12.1,3713,69687,117326,16.9,23234,77357,120344,17.4,-3018,-0.5,38752,46339,6.9,6.2,33.8,Mississippi,1987
137609,1870316,119876,16482,15.1,8145,12576,11.5,8070,206735,344344,18.4,54232,181053,300929,16.1,43415,2.3,91762,110633,7.4,6.4,32.2,Missouri,1987
17277,217775,15777,3186,14.7,1893,2933,13.5,1877,23972,41249,18.9,8804,23245,39022,17.9,2227,1.0,19005,21722,7.9,7.2,35.8,Montana,1987
32348,527217,33124,4629,12.1,2552,3928,10.2,2524,54869,87217,16.5,14757,44978,78102,14.8,9115,1.7,33068,38628,6.1,6.3,29.6,Nebraska,1987
41927,415841,26805,4226,19.4,1893,2976,13.7,1873,60590,102517,24.7,14675,39602,66407,16.0,36110,8.7,19135,22309,10.1,6.4,32.0,Nevada,1987
36549,444310,27611,5401,19.7,2037,3030,11.0,2032,52463,89012,20.0,14418,43322,70933,16.0,18079,4.0,25249,28557,8.2,6.2,32.0,New Hampshire,1987
253114,3053041,198113,26411,15.1,12555,18969,10.9,12492,368032,621146,20.3,86591,319027,517140,16.9,104006,3.4,155668,178070,8.3,6.5,33.8,New Jersey,1987
36907,393305,29618,4754,15.7,2622,3987,13.2,2608,43929,80836,20.6,16473,46870,76488,19.4,4348,1.2,25937,30459,9.4,7.5,38.8,New Mexico,1987
396993,6760940,382309,54495,14.0,31100,44355,11.4,30975,750947,1147940,17.0,201760,654669,1036978,15.3,110962,1.7,346612,394396,5.9,5.7,30.6,New York,1987
161377,2388193,140901,20694,15.6,9304,14436,10.9,9271,257227,418604,17.5,61799,241608,382509,16.0,36095,1.5,109913,135644,6.8,5.9,32.0,North Carolina,1987
12851,190797,10838,2119,12.5,1204,1871,11.0,1195,17520,30371,15.9,6034,17380,28218,14.8,2153,1.1,14755,17058,6.7,5.7,29.6,North Dakota,1987
253154,3834228,239028,28393,13.6,13196,21448,10.3,13069,411631,664785,17.3,94165,350739,589767,15.4,75018,1.9,168401,211958,6.6,6.2,30.8,Ohio,1987
72602,925714,78028,9301,13.7,6799,10158,15.0,6722,81332,153934,16.6,40496,117918,195946,21.2,-42012,-4.6,55905,66914,7.8,8.4,33.2,Oklahoma,1987
72283,876897,62050,10977,16.7,5650,8551,13.0,5621,103177,175460,20.0,34866,82222,144272,16.5,31188,3.5,56822,66905,8.2,7.1,33.0,Oregon,1987
268721,4211900,243157,31900,13.7,14768,23240,10.0,14650,441770,710491,16.9,107955,381901,625058,14.8,85433,2.1,194697,236702,6.4,5.8,29.6,Pennsylvania,1987
24483,388723,20445,3504,15.3,1650,2390,10.5,1637,43151,67634,17.4,10956,32441,52886,13.6,14748,3.8,20985,23374,6.3,5.3,27.2,Rhode Island,1987
83460,1089692,64762,10323,16.0,4688,7369,11.4,4649,127843,211303,19.4,30471,101304,166066,15.2,45237,4.2,53782,65831,7.7,5.9,30.4,South Carolina,1987
13100,198232,11308,2220,13.0,1209,1938,11.3,1202,18938,32038,16.2,6409,16703,28011,14.1,4027,2.1,15111,17196,6.6,5.7,28.2,South Dakota,1987
118339,1672313,110977,14691,15.7,7129,10644,11.4,7096,191234,309573,18.5,49284,156359,267336,16.0,42237,2.5,78066,95419,7.1,6.6,32.0,Tennessee,1987
466491,5478753,503652,53577,15.4,34860,53079,15.3,34454,547355,1013846,18.5,237080,741502,1245154,22.7,-231308,-4.2,273401,346457,8.5,9.2,37.0,Texas,1987
38705,496982,37675,5009,16.4,2566,4136,13.5,2522,58526,97231,19.6,17771,53781,91456,18.4,5775,1.2,25704,30862,7.8,7.6,36.8,Utah,1987
17618,207870,11434,2656,16.9,1134,1583,10.1,1121,22445,40063,19.3,6760,15807,27241,13.1,12822,6.2,14606,16245,8.5,5.5,26.2,Vermont,1987
173310,2036958,127025,19610,16.6,8285,12893,10.9,8210,238372,411682,20.2,53752,191232,318257,15.6,93425,4.6,96918,120928,8.5,6.2,31.2,Virginia,1987
125179,1423705,98808,17335,16.9,8438,13066,12.7,8351,179982,305161,21.4,53066,141492,240300,16.9,64861,4.5,88044,104592,8.8,6.9,33.8,Washington,1987
32401,452255,28164,4621,14.2,2415,3678,11.3,2402,42953,75354,16.7,14349,43916,72080,15.9,3274,0.8,27543,32931,7.2,6.2,31.8,West Virginia,1987
120228,1672542,60276,14396,14.5,1920,7186,7.3,1857,165742,285970,17.1,17586,130780,191056,11.4,94914,5.7,86963,103021,7.2,3.6,22.8,Wisconsin,1987
8937,127412,12294,1673,13.0,1196,1930,15.0,1188,10553,19490,15.3,6212,18637,30931,24.3,-11441,-9.0,11030,12660,7.0,9.6,30.6,Wyoming,1987
93070,1208299,73633,9836,13.3,5836,8891,12.1,5836,129015,222085,18.4,33259,115247,188880,15.6,33205,2.8,60133,74074,7.7,6.1,31.2,Alabama,1988
12815,133238,15402,1814,15.7,1148,1861,16.1,1148,17375,30190,22.7,6412,18157,33559,25.2,-3369,-2.5,9722,11502,9.6,11.6,45.4,Alaska,1988
116438,1141813,87104,11908,16.5,6765,10152,14.1,6765,148530,264968,23.2,44302,126977,214081,18.7,50887,4.5,58831,72792,10.2,7.6,37.4,Arizona,1988
46066,676843,41046,5764,12.6,3915,5683,12.4,3915,74680,120746,17.8,19632,61819,102865,15.2,17881,2.6,38802,45640,6.8,6.1,30.4,Arkansas,1988
822891,10149718,686503,89631,14.8,49545,75767,12.5,49544,1405242,2228133,22.0,319211,1117673,1804176,17.8,423957,4.2,505005,612513,8.1,6.8,35.6,California,1988
92574,1156028,92882,12191,14.9,8319,12132,14.9,8319,133862,226436,19.6,45630,123436,216318,18.7,10118,0.9,67973,81494,8.0,8.0,37.4,Colorado,1988
106749,1482419,95901,11063,13.9,5704,8430,10.6,5704,155394,262143,17.7,38946,142399,238300,16.1,23843,1.6,70038,80886,7.2,6.5,32.2,Connecticut,1988
20849,278434,15907,1965,13.8,982,1660,11.6,982,34482,55331,19.9,6084,23717,39624,14.2,15707,5.7,12312,14401,7.5,5.7,28.4,Delaware,1988
22092,412673,20728,2131,12.3,1124,1887,10.9,1124,48057,70149,17.0,10419,49203,69931,16.9,218,0.1,14784,17420,5.4,5.0,33.8,District of Columbia,1988
388618,4128970,305940,48708,16.8,28181,39613,13.7,28179,530071,918689,22.2,165880,424069,730009,17.7,188680,4.5,240864,294111,9.4,7.4,35.4,Florida,1988
203681,2334375,147951,19487,14.9,10464,15821,12.1,10461,286812,490493,21.0,65213,229807,377758,16.2,112735,4.8,105905,132685,8.7,6.3,32.4,Geogia,1988
25953,372821,20664,3087,12.8,1688,2558,10.6,1688,45175,71128,19.1,8967,32299,52963,14.2,18165,4.9,19794,24301,7.0,5.5,28.4,Hawaii,1988
21446,254539,16852,2746,12.8,1725,2564,12.0,1725,30491,51937,20.4,9259,24162,41014,16.1,10923,4.3,18123,21455,8.4,6.6,32.2,Idaho,1988
280592,4241579,218314,28147,12.3,15499,23732,10.3,15499,487064,767656,18.1,95916,362037,580351,13.7,187305,4.4,192616,231231,6.6,5.1,27.4,Illinois,1988
122440,1950551,114288,12975,11.9,7420,11344,10.4,7420,211912,334352,17.1,62030,162839,277127,14.2,57225,2.9,89111,109639,6.3,5.9,28.4,Indiana,1988
52194,893896,44142,6597,10.3,4301,6565,10.3,4300,106545,158739,17.8,20523,63071,107213,12.0,51526,5.8,52712,63826,5.8,4.9,24.0,Iowa,1988
58012,787135,46324,6994,12.1,4328,6377,11.0,4328,82026,140038,17.8,24363,71163,117487,14.9,22551,2.9,48576,58039,7.4,5.9,29.8,Kansas,1988
77680,1070294,59990,8637,12.9,5323,7582,11.3,5323,120944,198624,18.6,30685,92132,152122,14.2,46502,4.4,56081,67582,7.3,5.6,28.4,Kentucky,1988
84223,1157912,81808,9615,12.1,7153,10602,13.3,7153,136862,221085,19.1,40798,117066,198874,17.2,22211,1.9,64474,79045,7.3,7.1,34.4,Louisiana,1988
26867,399702,19332,4249,14.9,2191,3185,11.2,2191,52902,79769,20.0,10580,33769,53101,13.3,26668,6.7,25145,28904,6.7,4.8,26.6,Maine,1988
135241,1697971,97172,13530,14.5,6595,10254,11.0,6595,211042,346283,20.4,47169,187777,284949,16.8,61334,3.6,77607,94737,8.0,5.7,33.6,Maryland,1988
177471,2774318,152920,17905,12.9,9538,14404,10.4,9538,319298,496769,17.9,73354,270757,423677,15.3,73092,2.6,119327,140083,6.4,5.5,30.6,Massachusetts,1988
208433,3185315,171871,21535,12.3,12055,18880,10.8,12055,328796,537229,16.9,70380,317037,488908,15.3,48321,1.6,143989,175707,6.5,5.4,30.6,Michigan,1988
105018,1678821,92615,11332,12.2,6375,10005,10.8,6375,203385,308403,18.4,43109,152028,244643,14.6,63760,3.8,77716,93508,6.3,5.5,29.2,Minnesota,1988
47411,670222,37431,5580,12.1,3897,5642,12.3,3896,71422,118833,17.7,19049,58733,96164,14.3,22669,3.4,38013,45843,7.1,5.6,28.6,Mississippi,1988
124591,1854926,136131,14218,12.9,8419,12813,11.6,8419,200290,324881,17.5,46165,175153,311284,16.8,13597,0.7,91198,110815,6.7,7.3,33.6,Missouri,1988
14647,198085,16564,2677,12.6,1863,2868,13.5,1863,21620,36267,18.3,8789,21580,38144,19.3,-1877,-1.0,18279,21065,7.4,8.4,36.6,Montana,1988
35151,522236,28936,4190,11.0,2535,3867,10.2,2535,60676,95827,18.3,12417,41112,70048,13.4,25779,4.9,32283,38082,6.7,5.5,26.8,Nebraska,1988
41415,445287,35641,3865,17.0,2012,3002,13.2,2012,67933,109348,24.6,14137,46294,81935,18.4,27413,6.2,19608,23086,9.3,8.0,36.8,Nevada,1988
37679,439825,25338,4657,16.2,2503,3531,12.2,2503,52062,89741,20.4,13495,44178,69516,15.8,20225,4.6,25833,29339,8.6,5.8,31.6,New Hampshire,1988
215975,3112640,166432,24536,13.6,13325,19500,10.8,13325,373149,589124,18.9,70783,337311,503743,16.2,85381,2.7,158581,182189,6.9,5.3,32.4,New Jersey,1988
29824,382932,28320,4192,13.8,2750,4075,13.4,2750,46266,76090,19.9,15907,42095,70415,18.4,5675,1.5,25540,30306,7.8,7.4,36.8,New Mexico,1988
400716,6811429,368502,50752,12.8,31749,45035,11.4,31748,797883,1198599,17.6,171335,724497,1092999,16.0,105600,1.6,348575,398492,5.9,5.4,32.0,New York,1988
177742,2443107,123738,18924,13.8,9816,15115,11.0,9816,275522,453264,18.6,50902,206190,329928,13.5,123336,5.1,111672,138754,7.3,5.1,27.0,North Carolina,1988
11435,180615,10415,1784,10.7,1141,1802,10.8,1141,19060,30495,16.9,5221,14552,24967,13.8,5528,3.1,14344,16650,6.3,5.8,27.6,North Dakota,1988
258245,3939083,194273,25144,11.8,13475,22123,10.4,13474,430917,689162,17.5,76221,353534,547807,13.9,141355,3.6,170138,214686,6.6,4.9,27.8,Ohio,1988
65195,867352,63765,8135,12.4,6193,9274,14.1,6193,101533,166728,19.2,31929,85690,149455,17.2,17273,2.0,53602,64831,7.5,7.4,34.4,Oklahoma,1988
68200,887575,58644,9538,14.3,5723,8447,12.6,5723,117373,185573,20.9,29244,81133,139777,15.7,45796,5.2,56728,67301,7.7,6.6,31.4,Oregon,1988
262643,4298059,232102,28607,12.0,15467,23971,10.1,15464,468062,730705,17.0,106051,380802,612904,14.3,117801,2.7,197264,240412,6.1,5.4,28.6,Pennsylvania,1988
23170,397924,23556,3173,13.5,1766,2663,11.3,1766,45026,68196,17.1,9857,37837,61393,15.4,6803,1.7,21357,23771,5.8,5.9,30.8,Rhode Island,1988
102549,1121053,61085,9438,14.2,5129,7770,11.7,5129,126500,229049,20.4,27206,94565,155650,13.9,73399,6.5,54527,67141,9.1,5.4,27.8,South Carolina,1988
12910,190724,10800,1976,11.6,1202,1862,10.9,1202,19808,32718,17.2,5517,14881,25681,13.5,7037,3.7,14953,17063,6.8,5.7,27.0,South Dakota,1988
152148,1702024,107517,13377,14.0,7400,11071,11.5,7400,193921,346069,20.3,43981,158589,266106,15.6,79963,4.7,78439,96811,8.9,6.3,31.2,Tennessee,1988
457121,5365881,425297,47230,13.7,33950,50099,14.6,33950,646101,1103222,20.6,198917,599496,1024793,19.1,78429,1.5,266880,341407,8.5,7.9,38.2,Texas,1988
42591,492490,36742,4516,14.6,2835,4247,13.8,2835,58048,100639,20.4,18732,49720,86462,17.6,14177,2.8,25513,30856,8.6,7.5,35.2,Utah,1988
14333,204173,12776,2368,14.6,1281,1817,11.2,1281,21302,35635,17.5,6930,19514,32290,15.8,3345,1.7,14785,16484,7.0,6.3,31.6,Vermont,1988
169562,2105658,119238,17904,14.6,8730,13531,11.0,8730,249631,419193,19.9,47580,192681,311919,14.8,107274,5.1,99471,124670,8.1,5.7,29.6,Virginia,1988
113996,1461310,97694,15493,14.7,8499,13088,12.5,8497,209298,323294,22.1,46219,146393,244087,16.7,79207,5.4,88773,105987,7.8,6.7,33.4,Washington,1988
30540,447788,25633,3924,12.0,2395,3615,11.0,2395,46795,77335,17.3,12605,42530,68163,15.2,9172,2.1,27511,32973,6.8,5.7,30.4,West Virginia,1988
104054,1755600,75847,11564,11.2,6663,9948,9.6,6663,190523,294577,16.8,38149,137490,213337,12.2,81240,4.6,87621,104247,5.9,4.3,24.4,Wisconsin,1988
8670,119605,9280,1480,11.8,1060,1645,13.2,1060,13368,22038,18.4,4752,13048,22328,18.7,-290,-0.3,10765,12384,7.2,7.8,36.8,Wyoming,1988
91168,1259370,61080,10009,13.3,5685,8158,10.9,5660,141841,233009,18.5,34928,112241,173321,13.8,59688,4.7,61306,76014,7.2,4.9,27.6,Alabama,1989
16160,134618,17746,1495,13.7,887,2619,23.9,884,19749,35909,26.7,4217,12849,30595,22.7,5314,4.0,8518,10384,12.0,13.2,45.4,Alaska,1989
108617,1187751,89535,11479,15.7,6862,10299,14.0,6826,147788,256405,21.6,52184,130100,219635,18.5,36770,3.1,59371,73858,9.1,7.5,37.0,Arizona,1989
53331,702968,39392,5746,12.5,3622,5050,11.0,3561,75051,128382,18.3,25409,57861,97253,13.8,31129,4.5,39202,46467,7.6,5.6,27.6,Arkansas,1989
823088,10516224,806222,87685,14.3,49255,90078,14.7,48921,1391488,2214576,21.1,371483,1094656,1900878,18.1,313698,3.0,497327,610180,7.8,7.7,36.2,California,1989
94535,1182445,87671,11280,13.8,7398,11054,13.6,7366,141137,235672,19.9,48658,110635,198306,16.8,37366,3.1,67995,81688,8.0,7.4,33.6,Colorado,1989
89312,1500115,79016,10080,12.4,6146,8952,11.0,6102,157690,247002,16.5,39044,144475,223491,14.9,23511,1.6,70819,82079,6.0,5.3,29.8,Connecticut,1989
25642,295576,10963,2278,15.4,939,1468,9.9,935,32434,58076,19.6,6322,29233,40196,13.6,17880,6.0,12979,15238,8.7,3.7,27.2,Delaware,1989
21286,405978,21575,2055,11.7,1099,1844,10.5,1097,47129,68415,16.9,10076,37985,59560,14.7,8855,2.2,14740,17671,5.2,5.3,29.4,District of Columbia,1989
381828,4340752,292733,46039,15.5,26943,38421,12.9,26774,555365,937193,21.6,173642,443595,736328,17.0,200865,4.6,246158,301917,8.8,6.7,34.0,Florida,1989
204011,2432773,148101,18807,14.0,10446,15789,11.8,10394,287623,491634,20.2,77006,278996,427097,17.6,64537,2.6,107578,135772,8.4,6.1,35.2,Geogia,1989
28842,393082,19410,2970,12.1,1614,2428,9.9,1614,43726,72568,18.5,10181,31121,50531,12.9,22037,5.6,20055,24868,7.3,4.9,25.8,Hawaii,1989
23715,271892,15661,2836,13.1,1596,2469,11.4,1574,35329,59044,21.7,9385,21345,37006,13.6,22038,8.1,18394,21842,8.7,5.8,27.2,Idaho,1989
291149,4413452,209215,27828,11.9,15424,23572,10.1,15220,462224,753373,17.1,109927,396453,605668,13.7,147705,3.4,195191,235604,6.6,4.7,27.4,Illinois,1989
123044,2037085,93597,13116,11.8,7242,10645,9.6,7194,224480,347524,17.1,53326,155674,249271,12.2,98253,4.9,90618,112236,6.0,4.6,24.4,Indiana,1989
67668,947453,42751,6643,10.3,3999,5850,9.1,3994,99762,167430,17.7,22412,66570,109321,11.5,58109,6.2,53217,64661,7.1,4.5,23.0,Iowa,1989
80481,824926,44156,6609,11.4,4407,6329,10.9,4383,85671,166152,20.1,26349,69930,114086,13.8,52066,6.3,48577,58350,9.8,5.4,27.6,Kansas,1989
74254,1115697,58276,8303,12.2,4920,7008,10.3,4895,122472,196726,17.6,31698,93017,151293,13.6,45433,4.0,56900,68895,6.7,5.2,27.2,Kentucky,1989
82528,1186687,74312,8641,11.0,6229,9323,11.8,6186,141364,223892,18.9,42411,116729,191041,16.1,32851,2.8,63629,78520,7.0,6.3,32.2,Louisiana,1989
28191,420289,23589,4177,14.2,2308,3279,11.2,2274,48851,77042,18.3,14345,39654,63243,15.0,13799,3.3,25805,29875,6.7,5.6,30.0,Maine,1989
124332,1749401,93126,13061,13.6,6498,9983,10.4,6471,192933,317265,18.1,46466,186732,279858,16.0,37407,2.1,79783,97856,7.1,5.3,32.0,Maryland,1989
169011,2836688,140849,16701,11.8,10370,14844,10.5,10198,311186,480197,16.9,76971,295245,436094,15.4,44103,1.5,120312,142397,6.0,5.0,30.8,Massachusetts,1989
191563,3272939,144469,21646,12.2,11675,17318,9.7,11608,363703,555266,17.0,80289,291221,435690,13.3,119576,3.7,146920,180311,5.9,4.4,26.6,Michigan,1989
108311,1740605,92919,11414,12.1,6011,9196,9.7,5974,183985,292296,16.8,43493,139752,232671,13.4,59625,3.4,79180,95704,6.2,5.3,26.8,Minnesota,1989
45903,695980,39840,5583,12.1,3546,5062,11.0,3514,72162,118065,17.0,22423,60361,100201,14.4,17864,2.6,38176,46432,6.6,5.7,28.8,Mississippi,1989
120108,1900552,95615,14291,12.8,7996,11751,10.5,7935,220378,340486,17.9,53542,171597,267212,14.1,73274,3.8,92882,113353,6.3,5.0,28.2,Missouri,1989
16129,202220,11903,2701,12.8,1641,2460,11.6,1639,23741,39870,19.7,7672,17521,29424,14.6,10446,5.1,18447,21256,8.0,5.9,29.2,Montana,1989
34249,546735,27488,4293,11.2,2535,3776,9.9,2525,59152,93401,17.1,15480,42793,70281,12.9,23120,4.2,32512,38574,6.3,5.0,25.8,Nebraska,1989
40897,478236,33534,4142,17.5,1868,2856,12.0,1860,75467,116364,24.3,17097,46080,79614,16.6,36750,7.7,20656,24365,8.6,7.0,33.2,Nevada,1989
34409,455591,26212,4078,13.8,2741,3707,12.6,2715,44936,79345,17.4,17045,45370,71582,15.7,7763,1.7,25964,29721,7.6,5.8,31.4,New Hampshire,1989
209294,3186478,170248,22984,12.5,13748,20522,11.2,13692,362351,571645,17.9,89068,353786,524034,16.4,47611,1.5,159955,184810,6.6,5.3,32.8,New Jersey,1989
30448,389990,25475,4225,13.9,2586,3853,12.6,2568,44998,75446,19.3,15550,41715,67190,17.2,8256,2.1,25766,30708,7.8,6.5,34.4,New Mexico,1989
411152,6922355,351403,50602,12.6,31762,45366,11.3,31578,738375,1149527,16.6,195782,673236,1024639,14.8,124888,1.8,351755,404333,5.9,5.1,29.6,New York,1989
169917,2557204,119777,18299,13.0,9524,14564,10.4,9466,266740,436657,17.1,58887,244833,364610,14.3,72047,2.8,114402,142586,6.6,4.7,28.6,North Carolina,1989
11733,184980,9356,1673,10.0,1072,1554,9.3,1069,17256,28989,15.7,5263,14872,24228,13.1,4761,2.6,14374,16777,6.3,5.1,26.2,North Dakota,1989
266428,4096283,206482,24718,11.4,13439,20521,9.5,13319,433185,699613,17.1,92377,352719,559201,13.7,140412,3.4,172489,219033,6.5,5.0,27.4,Ohio,1989
62305,891090,58735,8224,12.6,5468,7926,12.2,5432,102391,164696,18.5,34900,80076,138811,15.6,25885,2.9,53837,65207,7.0,6.6,31.2,Oklahoma,1989
67689,919420,112226,8202,12.7,5178,13447,20.8,5143,132905,200594,21.8,31825,75352,187578,20.4,13016,1.4,51213,62002,7.4,12.2,40.8,Oregon,1989
260079,4409414,213035,28179,11.6,15157,22807,9.4,14985,453036,713115,16.2,105869,372676,585711,13.3,127404,2.9,201138,245949,5.9,4.8,26.6,Pennsylvania,1989
28036,404615,22655,3142,13.1,1919,2637,11.0,1892,38662,66698,16.5,14484,41264,63919,15.8,2779,0.7,21791,24360,6.9,5.6,31.6,Rhode Island,1989
81280,1182060,67168,8894,13.1,4872,7258,10.7,4855,128057,209337,17.7,36461,102900,170068,14.4,39269,3.3,55592,68817,6.9,5.7,28.8,South Carolina,1989
11312,198652,9745,1898,11.0,1116,1587,9.2,1116,22767,34079,17.2,5681,15602,25347,12.8,8732,4.4,15131,17346,5.7,4.9,25.6,South Dakota,1989
128938,1789321,97299,12914,13.2,7341,10607,10.8,7197,208621,337559,18.9,56822,164726,262025,14.6,75534,4.3,79653,99307,7.2,5.4,29.2,Tennessee,1989
438091,5508593,408980,44527,13.1,30014,45313,13.3,29642,701821,1139912,20.7,226498,554776,963756,17.5,176156,3.2,265421,340887,8.0,7.4,35.0,Texas,1989
46586,520388,34177,4173,13.5,2658,3979,12.9,2576,70045,116631,22.4,19902,48807,82984,15.9,33647,6.5,25495,31047,9.0,6.6,31.8,Utah,1989
14816,212300,10551,2444,14.6,1390,1861,11.1,1365,22146,36962,17.4,7117,15765,26316,12.4,10646,5.0,15271,17094,7.0,5.0,24.8,Vermont,1989
165216,2211800,110277,17512,13.8,8901,13557,10.7,8821,243625,408841,18.5,56501,206672,316949,14.3,91892,4.2,101909,128755,7.5,5.0,28.6,Virginia,1989
113917,1530599,202429,12963,13.0,8170,25690,25.8,8112,272000,385917,25.2,54996,129122,331551,21.7,54366,3.5,75543,93124,7.4,13.2,43.4,Washington,1989
33362,461621,23423,3795,11.4,2330,3398,10.2,2318,44048,77410,16.8,13893,40784,64207,13.9,13203,2.9,27714,33385,7.2,5.1,27.8,West Virginia,1989
94640,1834614,82812,11772,11.2,6573,9823,9.3,6536,201779,296419,16.2,44682,141592,224404,12.2,72015,4.0,88782,106209,5.2,4.5,24.4,Wisconsin,1989
8405,121576,7196,1423,11.5,937,1428,11.5,932,14697,23102,19.0,4581,11818,19014,15.6,4088,3.4,10698,12358,6.9,5.9,31.2,Wyoming,1989
72790,1308045,59017,9446,12.3,5556,7845,10.2,5512,144530,217320,16.6,35188,114913,173930,13.3,43390,3.3,62128,77158,5.6,4.5,26.6,Alabama,1990
22297,143520,7288,2828,25.2,649,1072,9.5,648,20866,43163,30.1,4045,15247,22535,15.7,20628,14.4,10157,12097,15.5,5.1,31.4,Alaska,1990
94689,1211932,79134,11266,15.1,6416,9402,12.6,6365,143199,237888,19.6,43173,139118,218252,18.0,19636,1.6,60339,75080,7.8,6.5,36.0,Arizona,1990
41301,730873,29107,5776,12.3,3321,4608,9.8,3319,77869,119170,16.3,17988,63456,92563,12.7,26607,3.6,39886,47312,5.7,4.0,25.4,Arkansas,1990
920105,10908220,619747,104509,16.7,45517,67345,10.8,45313,1365773,2285878,21.0,342700,1146406,1766153,16.2,519725,4.8,526427,642827,8.4,5.7,32.4,California,1990
93101,1220282,79909,11760,14.2,6478,9552,11.6,6444,135958,229059,18.8,45973,110159,190068,15.6,38991,3.2,69416,83404,7.6,6.5,31.2,Colorado,1990
74476,1497164,69670,9025,11.0,6003,8638,10.5,5973,127649,202125,13.5,37713,154075,223745,14.9,-21620,-1.4,70300,81871,5.0,4.7,27.0,Connecticut,1990
14302,308937,10085,2148,13.8,958,1445,9.3,958,32238,46540,15.1,5745,27348,37433,12.1,9107,3.0,13461,15859,4.6,3.3,24.2,Delaware,1990
18056,408738,17522,1880,10.7,1241,1970,11.2,1237,38782,56838,13.9,7679,43669,61191,15.0,-4353,-1.1,14497,17468,4.4,4.3,27.8,District of Columbia,1990
361686,4485056,284893,46520,15.2,26475,36577,12.0,26337,521385,883071,19.7,171200,472645,757538,16.9,125533,2.8,251806,309518,8.1,6.4,33.8,Florida,1990
161299,2487945,138080,17768,13.0,10188,15063,11.0,10128,282379,443678,17.8,69692,255758,393838,15.8,49840,2.0,108444,137562,6.5,5.5,31.6,Geogia,1990
27805,414778,18469,3227,12.8,1421,2199,8.7,1418,45969,73774,17.8,11112,32101,50570,12.2,23204,5.6,20775,25751,6.7,4.5,24.4,Hawaii,1990
18554,288998,13531,3311,14.8,1395,1991,8.9,1388,35973,54527,18.9,8422,27442,40973,14.2,13554,4.7,19489,23039,6.4,4.7,28.4,Idaho,1990
243317,4534140,186785,27028,11.4,14472,21638,9.1,14411,446787,690104,15.2,98184,397922,584707,12.9,105397,2.3,198556,239858,5.4,4.1,25.8,Illinois,1990
108421,2106302,82076,12940,11.4,6951,10020,8.8,6922,204817,313238,14.9,44788,181403,263479,12.5,49759,2.4,92188,114595,5.1,3.9,25.0,Indiana,1990
46380,991671,34759,6476,9.9,3717,5322,8.2,3704,96150,142530,14.4,21913,77059,111818,11.3,30712,3.1,53791,65557,4.7,3.5,22.6,Iowa,1990
50104,864234,41398,6412,11.0,4156,6004,10.3,4142,89735,139839,16.2,23465,69576,110974,12.8,28865,3.4,48532,58428,5.8,4.8,25.6,Kansas,1990
70528,1155358,52338,8451,12.1,4715,6669,9.6,4701,122828,193356,16.7,30148,99129,151467,13.1,41889,3.6,57929,70283,6.1,4.5,26.2,Kentucky,1990
80088,1224466,68473,8939,11.4,5561,8093,10.3,5509,146993,227081,18.5,38258,107675,176148,14.4,50933,4.1,63913,78977,6.5,5.6,28.8,Louisiana,1990
23721,420075,21725,3438,11.6,2410,3415,11.5,2405,35170,58891,14.0,13710,48182,69907,16.6,-11016,-2.6,25462,29606,5.6,5.2,28.0,Maine,1990
112712,1786035,89879,12822,12.9,6319,9704,9.8,6285,197522,310234,17.4,47001,179418,269297,15.1,40937,2.3,81789,100504,6.3,5.0,30.2,Maryland,1990
129901,2801266,145067,14558,10.3,10908,15630,11.1,10847,229965,359866,12.8,80959,327396,472463,16.9,-112597,-4.1,117524,140130,4.6,5.2,25.6,Massachusetts,1990
183946,3352229,140614,20782,11.4,11365,16673,9.2,11303,323881,507827,15.1,73224,324201,464815,13.9,43012,1.2,149076,183471,5.5,4.2,27.8,Michigan,1990
91717,1795142,80424,11162,11.5,5644,8687,9.0,5609,193600,285317,15.9,39262,148884,229308,12.8,56009,3.1,80981,97753,5.1,4.5,25.6,Minnesota,1990
39857,714218,33961,5585,12.0,3428,4830,10.4,3406,76267,116124,16.3,19871,60418,94379,13.2,21745,3.1,38524,46867,5.6,4.8,26.4,Mississippi,1990
111852,1952712,85123,13611,11.9,7486,11140,9.8,7453,192917,304769,15.6,45704,183973,269096,13.8,35673,1.8,94420,115207,5.7,4.4,27.6,Missouri,1990
13084,213359,11051,2583,12.0,1383,2072,9.7,1382,25080,38164,17.9,6907,17217,28268,13.2,9896,4.7,18796,21649,6.1,5.2,26.4,Montana,1990
29321,568260,21487,4048,10.4,2273,3409,8.8,2272,55999,85320,15.0,12667,42812,64299,11.3,21021,3.7,32829,39007,5.2,3.8,22.6,Nebraska,1990
36633,516403,25914,4281,17.1,1922,2740,10.9,1913,79598,116231,22.5,15904,49244,75158,14.6,41073,7.9,21800,25719,7.1,5.0,29.2,Nevada,1990
24597,455024,27967,3521,12.0,2888,3955,13.5,2886,37046,61643,13.5,17445,54626,82593,18.2,-20950,-4.7,25125,28975,5.4,6.1,27.0,New Hampshire,1990
187321,3202458,163199,21494,11.6,13396,19302,10.4,13363,314179,501500,15.7,82249,347395,510594,15.9,-9094,-0.2,159964,185608,5.8,5.1,31.4,New Jersey,1990
28895,401338,23112,4138,13.4,2255,3404,11.0,2243,47798,76693,19.1,13287,36237,59349,14.8,17344,4.3,26246,31208,7.2,5.8,29.6,New Mexico,1990
359067,6982030,332651,46931,11.6,31176,42872,10.6,31041,693090,1052157,15.1,187280,702303,1034954,14.8,17203,0.3,351934,405944,5.1,4.8,29.6,New York,1990
152507,2628527,125334,18136,12.6,9413,13775,9.5,9366,280179,432686,16.5,68490,228828,354162,13.5,78524,3.0,116947,145997,5.8,4.8,27.0,North Carolina,1990
8513,190600,7877,1609,9.6,1045,1461,8.7,1044,19249,27762,14.6,4778,13442,21319,11.2,6443,3.4,14394,16812,4.5,4.1,22.4,North Dakota,1990
216348,4198647,170517,23686,10.7,13041,19488,8.8,12957,392336,608684,14.5,95646,372633,543150,12.9,65534,1.6,174524,222305,5.2,4.1,25.8,Ohio,1990
57372,921164,47688,7968,12.2,4831,7012,10.7,4819,102640,160012,17.4,27956,76718,124406,13.5,35606,3.9,54368,65781,6.2,5.2,27.0,Oklahoma,1990
121443,962890,50403,14931,22.6,4159,6194,9.4,4128,107789,229232,23.8,27839,100720,151123,15.7,78109,8.1,59146,70345,12.6,5.2,31.4,Oregon,1990
210718,4516192,178341,26902,10.8,14647,21437,8.6,14589,442405,653123,14.5,97080,396193,574534,12.7,78589,1.8,204164,250224,4.7,3.9,25.4,Pennsylvania,1990
19017,398502,19475,2690,11.1,1883,2604,10.7,1882,32534,51551,12.9,10863,44541,64016,16.1,-12465,-3.2,21626,24238,4.8,4.9,25.8,Rhode Island,1990
74075,1223846,54731,8805,12.7,4770,6911,9.9,4751,131281,205356,16.8,30049,105059,159790,13.1,45566,3.7,56645,70208,6.1,4.5,26.2,South Carolina,1990
13611,206824,10083,2088,11.9,1081,1542,8.8,1080,22576,36187,17.5,5457,15394,25477,12.3,10710,5.2,15488,17756,6.6,4.9,24.6,South Dakota,1990
107860,1844231,87357,12319,12.3,7063,10252,10.3,7047,187307,295167,16.0,45448,172805,260162,14.1,35005,1.9,80435,100697,5.8,4.7,28.2,Tennessee,1990
423327,5693271,368195,46282,13.5,26209,38757,11.3,25945,705177,1128504,19.8,186064,546882,915077,16.1,213427,3.7,269514,346290,7.4,6.5,32.2,Texas,1990
36557,550160,29327,4189,13.3,2171,3226,10.3,2159,69539,106096,19.3,16072,48247,77574,14.1,28522,5.2,26102,31757,6.6,5.3,28.2,Utah,1990
11434,215990,11001,2009,11.7,1328,1789,10.4,1326,20141,31575,14.6,6384,21660,32661,15.1,-1086,-0.5,15309,17187,5.3,5.1,29.2,Vermont,1990
143467,2283216,106542,17340,13.3,8640,12922,9.9,8585,241439,384906,16.9,53343,222875,329417,14.4,55489,2.5,104373,132428,6.3,4.7,28.8,Virginia,1990
239874,1633703,128265,29651,28.7,5746,8909,8.6,5722,206274,446148,27.3,76956,165224,293489,18.0,152659,9.3,94750,113374,14.7,7.9,36.0,Washington,1990
27703,474967,22680,3837,11.4,2262,3177,9.5,2257,48927,76630,16.1,13957,39262,61942,13.0,14688,3.1,27960,33771,5.8,4.8,26.0,West Virginia,1990
94143,1897836,71211,11456,10.7,6129,8970,8.4,6099,179205,273348,14.4,38512,145271,216482,11.4,56866,3.0,90232,108203,5.0,3.8,22.8,Wisconsin,1990
7995,126413,7545,1461,11.8,824,1252,10.1,823,16026,24021,19.0,3949,10583,18128,14.3,5893,4.7,10838,12498,6.3,6.0,28.6,Wyoming,1990
89491,1330914,73332,9724,12.5,5238,8231,10.6,5175,124326,213817,16.1,36661,135468,208800,15.7,5017,0.4,62962,78721,6.7,5.5,31.4,Alabama,1991
12900,156297,8097,1933,15.6,726,1257,10.1,724,21366,34266,21.9,4227,18824,26921,17.2,7345,4.7,10628,12744,8.3,5.2,34.4,Alaska,1991
109364,1234743,80685,11762,15.4,5868,9233,12.1,5808,145021,254385,20.6,45391,147452,228137,18.5,26248,2.1,62102,77582,8.9,6.5,37.0,Arizona,1991
53785,753032,34904,6132,12.8,3267,4905,10.2,3244,71253,125038,16.6,20026,71535,106439,14.1,18599,2.5,40619,48560,7.1,4.6,28.2,Arkansas,1991
788570,11037302,715727,92230,14.2,47649,75868,11.7,47126,1167586,1956156,17.7,387619,1488560,2204287,20.0,-248131,-2.3,535853,659054,7.1,6.5,35.4,California,1991
99290,1255925,75714,12798,15.0,6061,9342,11.0,5973,136098,235388,18.7,41531,126698,202412,16.1,32976,2.6,72125,86888,7.9,6.0,32.2,Colorado,1991
85906,1464471,76438,8486,10.4,6078,9420,11.6,6023,118937,204843,14.0,38537,172321,248759,17.0,-43916,-3.0,68844,80861,5.9,5.2,28.0,Connecticut,1991
22864,312289,16622,2302,14.2,984,1625,10.0,970,26098,48962,15.7,5941,33695,50317,16.1,-1355,-0.4,13870,16554,7.3,5.3,31.4,Delaware,1991
20022,396999,18283,1987,11.3,983,1914,10.9,966,31566,51588,13.0,8076,51801,70084,17.7,-18496,-4.7,14623,17558,5.0,4.6,26.0,District of Columbia,1991
392545,4537628,317107,48435,15.4,25897,39708,12.7,25550,474120,866665,19.1,179638,574694,891801,19.7,-25136,-0.6,257912,318238,8.7,7.0,38.2,Florida,1991
184111,2479409,173620,19158,13.8,9665,15727,11.3,9452,232904,417015,16.8,92591,304334,477954,19.3,-60939,-2.5,110728,141028,7.4,7.0,33.6,Geogia,1991
33266,432427,19376,3547,13.5,1510,2368,9.0,1493,42101,75367,17.4,10270,47117,66493,15.4,8874,2.0,21514,26947,7.7,4.5,30.8,Hawaii,1991
22403,300810,15293,3232,13.8,1393,2238,9.5,1384,34952,57355,19.1,8255,31037,46330,15.4,11025,3.7,20210,23992,7.4,5.1,30.8,Idaho,1991
272756,4577187,211359,28231,11.6,14640,23286,9.6,14479,399344,672100,14.7,109221,471093,682452,14.9,-10352,-0.2,201406,244919,6.0,4.6,29.4,Illinois,1991
121954,2118027,94996,13543,11.7,7008,10656,9.2,6926,175748,297702,14.1,52981,223128,318124,15.0,-20422,-0.9,93769,117452,5.8,4.5,28.2,Indiana,1991
50102,1017620,37525,6972,10.5,3455,5312,8.0,3419,96704,146806,14.4,20816,88726,126251,12.4,20555,2.0,54774,67237,4.9,3.7,24.8,Iowa,1991
60093,879003,46014,7012,11.9,3915,6116,10.4,3863,77199,137292,15.6,25690,88997,135011,15.4,2281,0.2,48877,59283,6.8,5.2,30.8,Kansas,1991
80167,1179232,59560,8739,12.3,4719,6979,9.8,4683,108606,188773,16.0,35264,122521,182081,15.4,6692,0.6,58665,72020,6.8,5.1,30.8,Kentucky,1991
86306,1262182,75278,9684,12.1,5117,7905,9.9,5069,142599,228905,18.1,39181,129459,204737,16.2,24168,1.9,65002,80890,6.8,6.0,32.4,Louisiana,1991
21100,404958,20433,3368,11.4,2109,3311,11.2,2102,30411,51511,12.7,11487,49111,69544,17.2,-18033,-4.5,25173,29548,5.2,5.0,25.4,Maine,1991
116400,1771072,109939,12653,12.5,6910,11195,11.1,6824,152525,268925,15.2,51592,227756,337695,19.1,-68770,-3.9,82212,101909,6.6,6.2,30.4,Maryland,1991
128942,2655165,157859,14169,10.2,10311,16621,12.0,10168,204799,333741,12.6,77117,337793,495652,18.7,-161911,-6.1,114170,137550,4.9,5.9,25.2,Massachusetts,1991
191905,3323912,163671,20988,11.3,11472,17816,9.6,11298,269930,461835,13.9,87323,393061,556732,16.7,-94897,-2.8,150753,186622,5.8,4.9,27.8,Michigan,1991
112187,1814867,97851,12134,12.2,5714,9100,9.2,5633,155843,268030,14.8,52820,190041,287892,15.9,-19862,-1.1,82803,100739,6.2,5.4,29.6,Minnesota,1991
48507,729352,35613,5874,12.4,3140,4921,10.4,3118,67778,116285,15.9,20628,71308,106921,14.7,9364,1.2,39116,47929,6.7,4.9,29.4,Mississippi,1991
119509,1975910,105549,14140,12.2,7647,12084,10.4,7544,209037,328546,16.6,54642,204736,310285,15.7,18261,0.9,95513,117251,6.0,5.3,31.4,Missouri,1991
15863,220000,11195,2808,12.8,1408,2105,9.6,1397,21284,37147,16.9,7192,22702,33897,15.4,3250,1.5,19299,22338,7.2,5.1,30.8,Montana,1991
35081,585726,23795,4464,11.3,2264,3429,8.7,2231,52838,87919,15.0,14503,50048,73843,12.6,14076,2.4,33400,40077,6.0,4.1,25.2,Nebraska,1991
39713,542356,27386,4527,17.1,1953,2992,11.3,1936,61499,101212,18.7,17740,65581,92967,17.1,8245,1.6,22934,27226,7.3,5.0,34.2,Nevada,1991
25233,423405,28585,3439,12.0,2517,3841,13.4,2493,31509,56742,13.4,17074,53568,82153,19.4,-25411,-6.0,24446,28472,6.0,6.8,26.8,New Hampshire,1991
175021,3124754,178773,20917,11.3,13722,21786,11.8,13612,275783,450804,14.4,87088,402780,581553,18.6,-130749,-4.2,158005,184425,5.6,5.7,28.8,New Jersey,1991
38940,417522,26929,4573,14.4,2129,3459,10.9,2116,44965,83905,20.1,14617,42269,69198,16.6,14707,3.5,27094,32331,9.3,6.4,33.2,New Mexico,1991
372391,6859689,369220,47197,11.6,31215,46332,11.4,31048,568277,940668,13.7,202918,844698,1213918,17.7,-273250,-4.0,350517,407232,5.4,5.4,27.4,New York,1991
152642,2614322,143023,18112,12.3,9829,15405,10.5,9695,207665,360307,13.8,69780,307939,450962,17.2,-90655,-3.4,118321,148645,5.8,5.5,27.6,North Carolina,1991
13472,197234,8848,1811,10.7,981,1536,9.1,977,18456,31928,16.2,5615,17294,26142,13.3,5786,2.9,14520,17091,6.8,4.5,26.6,North Dakota,1991
222206,4196084,197271,24149,10.8,12760,20380,9.1,12631,345493,567699,13.5,103279,435586,632857,15.1,-65158,-1.6,176311,225884,5.3,4.7,27.0,Ohio,1991
66400,944302,50642,8695,13.0,4351,6719,10.1,4316,91880,158280,16.8,28679,96903,147545,15.6,10735,1.2,55933,67825,7.0,5.4,31.2,Oklahoma,1991
78666,1011444,59672,10174,14.2,4955,7709,10.8,4868,111264,189930,18.8,30992,107468,167140,16.5,22790,2.3,60664,72684,7.8,5.9,33.0,Oregon,1991
243293,4538975,223119,26772,10.6,14985,23304,9.3,14753,381163,624456,13.8,107675,460925,684044,15.1,-59588,-1.3,205750,253646,5.4,4.9,27.6,Pennsylvania,1991
21496,383606,19732,2439,10.2,1856,2896,12.1,1836,28973,50469,13.2,11803,48081,67813,17.7,-17344,-4.5,21104,23742,5.6,5.1,26.4,Rhode Island,1991
89557,1236964,66002,9557,13.4,4531,7265,10.2,4482,100933,190490,15.4,32133,140946,206948,16.7,-16458,-1.3,58022,72468,7.2,5.3,30.8,South Carolina,1991
16034,218618,8618,2208,12.2,989,1526,8.4,988,22860,38894,17.8,5264,18429,27047,12.4,11847,5.4,15927,18430,7.3,3.9,24.8,South Dakota,1991
130950,1853527,100794,12947,12.7,6785,10592,10.4,6708,165593,296543,16.0,53053,208176,308970,16.7,-12427,-0.7,81672,103073,7.1,5.4,32.0,Tennessee,1991
467778,5857767,393103,50053,14.2,24492,38985,11.1,24110,676692,1144470,19.5,214374,627266,1020369,17.4,124101,2.1,277327,357380,8.0,6.7,34.8,Texas,1991
44450,579626,30313,4739,14.6,2082,3307,10.2,2065,72546,116996,20.2,18817,57012,87325,15.1,29671,5.1,27233,33225,7.7,5.2,30.2,Utah,1991
11213,210592,11162,1858,10.8,1197,1832,10.7,1192,15405,26618,12.6,6894,25417,36579,17.4,-9961,-4.8,15232,17207,5.3,5.3,25.2,Vermont,1991
145398,2266314,133978,16840,12.6,9141,15030,11.3,9026,185934,331332,14.6,62711,284683,418661,18.5,-87329,-3.9,104776,134097,6.4,5.9,29.2,Virginia,1991
121174,1727614,104319,17247,14.9,7515,12110,10.5,7441,198564,319738,18.5,48589,193747,298066,17.3,21672,1.2,98342,118435,7.0,6.0,34.6,Washington,1991
33305,481431,22048,3985,11.7,2073,3257,9.6,2052,40178,73483,15.3,13523,48865,70913,14.7,2570,0.6,28321,34474,6.9,4.6,29.4,West Virginia,1991
103347,1931269,76213,12429,11.3,6113,9237,8.4,6022,160511,263858,13.7,43264,175739,251952,13.0,11906,0.7,92050,111392,5.4,3.9,26.0,Wisconsin,1991
9213,132036,5751,1681,13.2,762,1179,9.2,759,15315,24528,18.6,3866,13299,19050,14.4,5478,4.2,11227,13014,7.0,4.4,28.8,Wyoming,1991
76427,1346402,67093,10063,12.6,5574,8215,10.3,5494,144192,220619,16.4,37434,130663,197756,14.7,22863,1.7,63918,80283,5.7,5.0,29.4,Alabama,1992
12401,162050,9499,1968,15.1,860,1419,10.9,846,23607,36008,22.2,5463,21776,31275,19.3,4733,2.9,10879,13231,7.7,5.9,38.6,Alaska,1992
99526,1248051,98726,11685,14.9,6434,10040,12.8,6257,147052,246578,19.8,43024,144297,243023,19.5,3555,0.3,63128,78859,8.0,7.9,39.0,Arizona,1992
44686,773067,38106,6354,12.9,3614,5200,10.6,3558,88407,133093,17.2,21298,74141,112247,14.5,20846,2.7,41160,49488,5.8,4.9,29.0,Arkansas,1992
813263,10732102,797104,87403,13.3,55671,85165,12.9,54681,1167373,1980636,18.5,436805,1446519,2243623,20.9,-262987,-2.4,529679,656532,7.6,7.4,37.0,California,1992
100552,1292916,84683,12983,14.7,6612,10311,11.7,6499,153987,254539,19.7,45003,124674,209357,16.2,45182,3.5,74094,89165,7.8,6.5,32.4,Colorado,1992
68031,1423706,72314,8432,10.5,5916,9147,11.4,5837,129540,197571,13.9,36640,161184,233498,16.4,-35927,-2.5,67353,79633,4.8,5.1,27.8,Connecticut,1992
16844,306365,20740,2285,13.7,1084,1872,11.2,1078,27691,44535,14.5,6205,33349,54089,17.7,-9554,-3.2,14035,16883,5.5,6.8,29.0,Delaware,1992
36171,394956,16642,1985,11.2,1015,1784,10.1,1001,36535,72706,18.4,8118,41594,58236,14.7,14470,3.7,14639,17712,9.2,4.2,29.4,District of Columbia,1992
383699,4541774,361525,50409,15.7,28545,42391,13.2,28019,520326,904025,19.9,186814,513836,875361,19.3,28664,0.6,263140,324622,8.4,8.0,38.6,Florida,1992
180370,2476106,169463,20113,14.1,10466,16666,11.7,10233,287942,468312,18.9,78970,242903,412366,16.7,55946,2.2,113048,143866,7.3,6.8,33.4,Geogia,1992
25427,441837,20482,3140,11.6,1788,2794,10.3,1756,51436,76863,17.4,10274,46029,66511,15.1,10352,2.3,21464,27167,5.8,4.6,30.2,Hawaii,1992
26722,315744,15977,3552,14.5,1611,2485,10.1,1591,38474,65196,20.6,9548,31044,47021,14.9,18175,5.7,21016,24955,8.5,5.1,29.8,Idaho,1992
274538,4579284,225520,28583,11.6,15396,24543,10.0,15142,481416,755954,16.5,108970,478625,704145,15.4,51809,1.1,202758,247905,6.0,4.9,30.8,Illinois,1992
129067,2130456,98676,13643,11.5,7408,11239,9.5,7282,216178,345245,16.2,51973,198404,297080,13.9,48165,2.3,94728,119531,6.1,4.6,27.8,Indiana,1992
57266,1023283,47465,7059,10.4,3875,5932,8.8,3821,98748,156014,15.2,24541,101537,149002,14.6,7012,0.6,55206,68184,5.6,4.6,29.2,Iowa,1992
53039,883294,46138,7109,11.9,3893,5939,9.9,3831,87064,140103,15.9,26719,86313,132451,15.0,7652,0.9,49393,60233,6.0,5.2,30.0,Kansas,1992
63288,1189978,58632,8704,12.0,5174,7525,10.4,5114,118443,181731,15.3,33801,109703,168335,14.1,13396,1.2,59039,72943,5.3,4.9,28.2,Kentucky,1992
80995,1284338,74304,9854,12.1,5421,8308,10.2,5292,157263,238258,18.6,40216,140854,215158,16.8,23100,1.8,65815,82139,6.3,5.8,33.6,Louisiana,1992
20899,391145,22696,3375,11.4,2093,3238,11.0,2054,35180,56079,14.3,10969,40819,63515,16.2,-7436,-1.9,24977,29470,5.3,5.8,28.6,Maine,1992
107603,1723791,97369,12701,12.4,6755,11132,10.8,6609,177908,285511,16.6,46573,211554,308923,17.9,-23412,-1.3,82786,103147,6.2,5.6,33.2,Maryland,1992
135569,2559000,135513,14705,10.7,9426,14970,10.9,9271,247915,383484,15.0,66267,274518,410031,16.0,-26547,-1.0,112484,136582,5.3,5.3,30.0,Massachusetts,1992
167285,3301018,150402,21177,11.2,10834,17652,9.4,10678,352978,520263,15.8,76009,318133,468535,14.2,51728,1.6,152282,189397,5.1,4.6,28.4,Michigan,1992
97946,1822713,87576,12065,11.9,6324,9970,9.8,6204,193085,291031,16.0,44057,162508,250084,13.7,40947,2.3,83751,102474,5.4,4.8,27.4,Minnesota,1992
37542,734471,35435,5798,12.0,3354,5075,10.5,3314,79676,117218,16.0,19983,71606,107041,14.6,10177,1.4,39423,48416,5.1,4.8,29.2,Mississippi,1992
108320,1987304,97840,14246,12.1,8040,12404,10.5,7913,202522,310842,15.6,48897,200978,298818,15.0,12024,0.6,96336,118633,5.5,4.9,30.0,Missouri,1992
15091,228382,12150,3069,13.5,1548,2302,10.1,1533,30292,45383,19.9,7912,18877,31027,13.6,14356,6.3,19780,23061,6.6,5.3,27.2,Montana,1992
30305,594127,25394,4442,11.0,2411,3692,9.1,2366,59437,89742,15.1,14040,53424,78818,13.3,10924,1.8,33831,40666,5.1,4.3,26.6,Nebraska,1992
39364,546736,30477,4589,16.6,2367,3592,13.0,2343,53012,92376,16.9,16144,61823,92300,16.9,76,0.0,23416,28079,7.2,5.6,33.8,Nevada,1992
25656,411639,22538,3616,12.7,2292,3332,11.7,2250,42450,68106,16.5,13925,42541,65079,15.8,3027,0.7,24211,28590,6.2,5.5,31.6,New Hampshire,1992
159478,3044202,163938,21104,11.4,12978,20403,11.1,12842,342884,502362,16.5,73121,345252,509190,16.7,-6828,-0.2,157103,183921,5.2,5.4,33.0,New Jersey,1992
34614,428861,27287,4599,14.1,2322,3677,11.2,2278,55221,89835,20.9,13989,49103,76390,17.8,13445,3.1,27468,33023,8.1,6.4,35.6,New Mexico,1992
381653,6676973,368634,46121,11.4,33001,47403,11.7,32517,694328,1075981,16.1,197188,724405,1093039,16.4,-17058,-0.3,345484,403364,5.7,5.5,32.2,New York,1992
149148,2596790,131811,17939,12.0,9961,15352,10.2,9813,276156,425304,16.4,60525,231911,363722,14.0,61582,2.4,119096,150549,5.7,5.1,28.0,North Carolina,1992
10931,202318,8949,1825,10.6,1060,1612,9.4,1047,20572,31503,15.6,5142,17126,26075,12.9,5428,2.7,14514,17226,5.4,4.4,25.8,North Dakota,1992
194745,4161441,181546,23913,10.5,13463,21555,9.5,13219,398528,593273,14.3,86135,405152,586698,14.1,6575,0.2,176694,227682,4.7,4.4,28.2,Ohio,1992
59875,950584,58979,8789,12.8,5130,7390,10.8,5040,100375,160250,16.9,31593,96074,155053,16.3,5197,0.6,56510,68949,6.3,6.2,32.6,Oklahoma,1992
68390,1022136,59332,10166,13.8,5196,8043,10.9,5131,110034,178424,17.5,32875,114525,173857,17.0,4567,0.5,61952,74465,6.7,5.8,34.0,Oregon,1992
227241,4488384,214803,25601,10.1,16115,24738,9.7,15873,408920,636161,14.2,103202,450509,665312,14.8,-29151,-0.6,204368,253696,5.1,4.8,28.4,Pennsylvania,1992
18093,367863,22229,2590,11.0,1803,2734,11.6,1775,33760,51853,14.1,12307,40029,62258,16.9,-10405,-2.8,20701,23354,4.9,6.0,28.2,Rhode Island,1992
75754,1241171,58743,9238,12.6,5122,7882,10.8,5055,122930,198684,16.0,31848,120346,179089,14.4,19595,1.6,58601,73449,6.1,4.7,28.8,South Carolina,1992
13577,229407,11517,2201,11.8,1196,1815,9.7,1185,26383,39960,17.4,6948,19060,30577,13.3,9383,4.1,16093,18764,5.9,5.0,26.6,South Dakota,1992
109151,1868443,99882,13044,12.6,7246,11228,10.8,7132,212388,321539,17.2,49124,172625,272507,14.6,49032,2.6,82534,104471,5.8,5.3,29.2,Tennessee,1992
470128,5950058,398255,51501,14.2,27201,42127,11.6,26555,685998,1156126,19.4,206550,670520,1068775,18.0,87351,1.4,282598,365314,7.9,6.7,36.0,Texas,1992
43472,603564,41182,4999,14.8,2449,3789,11.2,2414,74799,118271,19.6,23583,58678,99860,16.5,18411,3.1,28181,34343,7.2,6.8,33.0,Utah,1992
11337,205790,9135,1903,11.1,1200,1776,10.3,1194,19910,31247,15.2,6082,20256,29391,14.3,1856,0.9,15163,17195,5.5,4.4,28.6,Vermont,1992
141088,2231301,125790,17097,12.7,9197,14825,11.0,8969,233206,374294,16.8,62989,233861,359651,16.1,14643,0.7,105795,135803,6.3,5.6,32.2,Virginia,1992
119751,1761545,109327,18240,15.1,8554,13279,11.0,8458,232890,352641,20.0,50743,189696,299023,17.0,53618,3.0,101511,122631,6.8,6.2,34.0,Washington,1992
25278,481350,26888,3828,11.0,2121,3382,9.8,2104,47471,72749,15.1,12299,47951,74839,15.5,-2090,-0.4,28485,34743,5.3,5.6,30.2,West Virginia,1992
86215,1954788,79130,11883,10.6,6480,10101,9.0,6406,186864,273079,14.0,38972,162265,241395,12.3,31684,1.7,92741,112804,4.4,4.0,24.6,Wisconsin,1992
8672,135874,7409,1710,13.0,764,1301,9.9,757,16239,24911,18.3,4371,15033,22442,16.5,2469,1.8,11513,13338,6.4,5.5,33.0,Wyoming,1992
64949,1383184,61198,9482,11.7,5360,7837,9.7,5343,152736,217685,15.7,31016,118110,179308,13.0,38377,2.7,65394,81689,4.7,4.4,26.0,Alabama,1993
9464,165637,9148,1737,13.0,848,1451,10.9,840,22174,31638,19.1,4586,19551,28699,17.3,2939,1.8,11184,13481,5.7,5.5,34.6,Alaska,1993
90983,1274754,78183,11194,14.0,6028,9275,11.6,5987,158866,249849,19.6,37389,124075,202258,15.9,47591,3.7,65112,80516,7.1,6.1,31.8,Arizona,1993
42142,797039,35748,6164,12.3,3489,4870,9.7,3445,88275,130417,16.4,18979,64749,100497,12.6,29920,3.8,42387,50628,5.3,4.5,25.2,Arkansas,1993
669902,10547691,717950,75603,11.6,54099,82362,12.7,53343,1242824,1912726,18.1,337326,1242754,1960704,18.6,-47978,-0.5,523374,645597,6.4,6.8,36.2,California,1993
86970,1345000,73079,13173,14.5,6127,9490,10.4,6093,170260,257230,19.1,35660,120298,193377,14.4,63853,4.7,77907,92656,6.5,5.4,28.8,Colorado,1993
59721,1402788,60131,7808,9.8,5054,7696,9.7,5023,146873,206594,14.7,29100,149841,209972,15.0,-3378,-0.3,67538,79579,4.3,4.3,29.4,Connecticut,1993
16479,302401,15455,2026,11.9,1047,1745,10.3,1045,30980,47459,15.7,6557,29605,45060,14.9,2399,0.8,14343,17100,5.4,5.1,29.8,Delaware,1993
16050,414809,18062,1618,9.2,931,1813,10.3,927,62321,78371,18.9,6106,35354,53416,12.9,24955,6.0,14585,17491,3.9,4.4,25.8,District of Columbia,1993
368147,4644368,312395,48544,14.8,28105,39997,12.2,27778,589430,957577,20.6,175123,472521,784916,16.9,172661,3.7,272178,332350,7.9,6.7,33.8,Florida,1993
162589,2540489,135669,19231,13.2,10003,15262,10.5,9955,286128,448717,17.7,66232,238751,374420,14.7,74297,3.0,117021,147510,6.4,5.3,29.4,Geogia,1993
21333,438664,22087,2824,10.4,1848,2806,10.4,1840,37688,59021,13.5,10282,51749,73836,16.8,-14815,-3.3,21464,27064,4.9,5.0,27.0,Hawaii,1993
20819,329085,16253,3427,13.5,1646,2518,9.9,1644,38181,59000,17.9,9368,33003,49256,15.0,9744,2.9,21841,25761,6.3,4.9,30.0,Idaho,1993
233014,4609541,205150,26409,10.6,14889,22911,9.2,14781,462017,695031,15.1,89863,465584,670734,14.6,24297,0.5,206074,250735,5.1,4.5,29.2,Illinois,1993
94277,2180336,86940,12591,10.5,7135,10483,8.7,7089,230055,324332,14.9,43290,184321,271261,12.4,53071,2.5,96817,121418,4.3,4.0,24.8,Indiana,1993
41013,1035736,35761,6226,9.1,3787,5617,8.2,3768,96802,137815,13.3,19290,83208,118969,11.5,18846,1.8,55783,68639,4.0,3.5,23.0,Iowa,1993
41789,891512,39453,6421,10.6,3753,5599,9.2,3722,87268,129057,14.5,21944,79294,118747,13.3,10310,1.2,50181,60925,4.7,4.4,26.6,Kansas,1993
66685,1216362,56104,8334,11.3,4885,7173,9.8,4861,129303,195988,16.1,28067,98841,154945,12.7,41043,3.4,60115,73934,5.5,4.6,25.4,Kentucky,1993
73452,1301148,67445,9085,11.0,5260,7729,9.3,5236,146961,220413,16.9,38046,139858,207303,15.9,13110,1.0,67301,83407,5.6,5.2,31.8,Louisiana,1993
24220,395352,17940,3264,11.0,1940,2906,9.8,1917,42433,66653,16.9,9508,31835,49775,12.6,16878,4.3,25253,29690,6.1,4.5,25.2,Maine,1993
95294,1708351,91177,11932,11.5,6583,10935,10.6,6522,174121,269415,15.8,45729,181703,272880,16.0,-3465,-0.2,84307,103875,5.6,5.3,31.6,Maryland,1993
125931,2567055,116624,13717,10.0,8519,13077,9.6,8411,276078,402009,15.7,51185,240064,356688,13.9,45321,1.8,113330,136982,4.9,4.5,27.8,Massachusetts,1993
154486,3361977,134966,19527,10.3,11357,17211,9.0,11274,352923,507409,15.1,67692,297381,432347,12.9,75062,2.2,154549,191270,4.6,4.0,25.8,Michigan,1993
98980,1874729,75485,11352,11.0,5693,8712,8.4,5627,193009,291989,15.6,36385,154193,229678,12.3,62311,3.3,86216,104867,5.3,4.0,24.6,Minnesota,1993
45463,754275,38000,5852,12.0,3418,4752,9.7,3410,81202,126665,16.8,20646,60025,98025,13.0,28640,3.8,40418,49450,6.0,5.0,26.0,Mississippi,1993
95582,1999829,96931,13511,11.3,7949,11697,9.8,7881,198719,294301,14.7,49493,183353,280284,14.0,14017,0.7,98232,120257,4.8,4.8,28.0,Missouri,1993
15731,238202,11835,2807,12.1,1596,2319,10.0,1586,27331,43062,18.1,7884,23209,35044,14.7,8018,3.4,20244,23467,6.6,5.0,29.4,Montana,1993
26530,606482,21526,4003,9.8,2409,3553,8.7,2398,60324,86854,14.3,11995,51266,72792,12.0,14062,2.3,34218,41023,4.4,3.5,24.0,Nebraska,1993
40568,557565,29621,4404,15.5,2322,3532,12.4,2289,61302,101870,18.3,17443,48629,78250,14.0,23620,4.3,24180,28788,7.3,5.3,28.0,Nevada,1993
21454,416203,19890,3244,11.3,1984,3006,10.5,1976,42630,64084,15.4,9353,37349,57239,13.8,6845,1.6,24402,28745,5.2,4.8,27.6,New Hampshire,1993
153993,3051256,149481,20496,11.1,12029,18032,9.7,11983,339327,493320,16.2,64480,329039,478520,15.7,14800,0.5,159542,186014,5.0,4.9,31.4,New Jersey,1993
28707,442894,23351,4252,12.7,2258,3395,10.2,2255,54137,82844,18.7,11832,44147,67498,15.2,15346,3.5,28429,33868,6.5,5.3,30.4,New Mexico,1993
339819,6618134,320965,44518,11.0,30582,43521,10.8,30398,666967,1006786,15.2,165063,747120,1068085,16.1,-61299,-0.9,346038,403359,5.1,4.8,30.4,New York,1993
124381,2665585,110538,16716,11.0,9536,14088,9.3,9465,281672,406053,15.2,56224,224092,334630,12.6,71423,2.6,121364,152781,4.7,4.1,25.2,North Carolina,1993
9879,208522,7644,1696,9.8,978,1431,8.3,976,20447,30326,14.5,4535,15701,23345,11.2,6981,3.3,14735,17451,4.7,3.7,22.4,North Dakota,1993
191069,4206104,181386,22123,9.7,12784,20558,9.0,12654,436939,628008,14.9,77428,362644,544030,12.9,83978,2.0,179233,228860,4.5,4.3,25.8,Ohio,1993
56347,964462,48341,8068,11.6,4674,6921,10.0,4652,102832,159179,16.5,24824,87382,135723,14.1,23456,2.4,57797,69955,5.8,5.0,28.2,Oklahoma,1993
59020,1038875,51948,9445,12.6,5084,7806,10.4,5056,121397,180417,17.4,25547,99097,151045,14.5,29372,2.9,63624,75844,5.7,5.0,29.0,Oregon,1993
199415,4486581,186450,22871,9.0,15156,22817,9.0,15039,422690,622105,13.9,91771,412034,598484,13.3,23621,0.6,204517,253027,4.4,4.2,26.6,Pennsylvania,1993
21994,367391,17028,2581,11.0,1468,2234,9.5,1463,35480,57474,15.6,7915,31063,48091,13.1,9383,2.5,21054,23688,6.0,4.6,26.2,Rhode Island,1993
63611,1264276,55605,8759,11.8,4910,7283,9.8,4886,122805,186416,14.7,25552,107607,163212,12.9,23204,1.8,59863,74751,5.0,4.4,25.8,South Carolina,1993
14321,239186,10676,2029,10.7,1125,1650,8.7,1115,25097,39418,16.5,5551,18381,29057,12.1,10361,4.4,16460,19109,6.0,4.5,24.2,South Dakota,1993
102637,1918641,85139,12427,11.8,6787,10128,9.6,6705,212275,314912,16.4,42833,176702,261841,13.6,53071,2.8,84669,106500,5.3,4.4,27.2,Tennessee,1993
410514,6078760,373822,47588,12.9,26434,40533,11.0,26186,773750,1184264,19.5,182144,632901,1006723,16.6,177541,2.9,290051,371330,6.8,6.1,33.2,Texas,1993
38700,630258,33761,4941,14.1,2397,3617,10.4,2383,78102,116802,18.5,18113,47682,81443,12.9,35359,5.6,29422,35529,6.1,5.4,25.8,Utah,1993
10379,210647,9491,1932,11.2,1144,1660,9.6,1142,21054,31433,14.9,5405,15604,25095,11.9,6338,3.0,15434,17460,4.9,4.5,23.8,Vermont,1993
127448,2310575,104246,15718,11.5,8458,13294,9.7,8403,339997,467445,20.2,48035,214779,319025,13.8,148420,6.4,108229,137903,5.5,4.5,27.6,Virginia,1993
106150,1817669,96683,16684,13.4,8687,13251,10.7,8618,198210,304360,16.7,48839,183494,280177,15.4,24183,1.3,104643,125528,5.8,5.3,30.8,Washington,1993
21231,483328,21332,3487,10.0,2107,3143,9.0,2091,49775,71006,14.7,11248,42815,64147,13.3,6859,1.4,28810,35012,4.4,4.4,26.6,West Virginia,1993
89099,1999055,77760,11771,10.3,6497,9501,8.3,6420,198534,287633,14.4,39149,153393,231153,11.6,56480,2.8,94771,114878,4.5,3.9,23.2,Wisconsin,1993
10617,139356,7634,1855,13.7,885,1337,9.8,876,14803,25420,18.2,4694,14785,22419,16.1,3001,2.1,11868,13822,7.6,5.5,32.2,Wyoming,1993
84306,1415009,63659,10389,12.6,5518,8070,9.8,5492,137362,221668,15.7,36087,125798,189457,13.4,32211,2.3,67204,83751,6.0,4.5,26.8,Alabama,1994
12698,169205,9253,1814,13.3,847,1437,10.5,841,21317,34015,20.1,3908,20172,29425,17.4,4590,2.7,11511,13796,7.5,5.5,34.8,Alaska,1994
113564,1341461,77888,12639,15.4,6204,9122,11.1,6185,178619,292183,21.8,39110,124770,202658,15.1,89525,6.7,67685,83748,8.5,5.8,30.2,Arizona,1994
52223,821074,45335,6622,12.9,3628,5046,9.8,3616,81528,133751,16.3,24531,67422,112757,13.7,20994,2.6,43467,52021,6.4,5.5,27.4,Arkansas,1994
700042,10483851,682970,80453,12.5,51500,79079,12.3,51095,1101752,1801794,17.2,361010,1159984,1842954,17.6,-41160,-0.4,522330,643643,6.7,6.5,34.4,California,1994
104037,1404918,80050,14746,15.5,6670,9880,10.4,6642,162739,266776,19.0,39229,128093,208143,14.8,58633,4.2,81787,97238,7.4,5.7,29.6,Colorado,1994
61086,1386909,69347,8129,10.2,5017,7555,9.5,4994,129755,190841,13.8,37964,140147,209494,15.1,-18653,-1.3,67788,79927,4.4,5.0,27.6,Connecticut,1994
17330,316508,11910,2201,12.7,1022,1670,9.6,1022,53962,71292,22.5,5436,33954,45864,14.5,25428,8.0,14714,17592,5.5,3.8,29.0,Delaware,1994
19632,419062,14736,1787,10.2,924,1568,8.9,903,34180,53812,12.8,5120,61232,75968,18.1,-22156,-5.3,14706,17665,4.7,3.5,25.6,District of Columbia,1994
369007,4817216,289054,49400,14.7,29079,40623,12.1,28951,583144,952151,19.8,175612,468058,757112,15.7,195039,4.1,278292,339954,7.7,6.0,31.4,Florida,1994
181930,2625414,140539,20675,13.8,10682,16053,10.7,10626,294747,476677,18.2,66569,221311,361850,13.8,114827,4.4,120395,151723,6.9,5.4,27.6,Geogia,1994
26245,426549,25343,2794,10.3,1780,2674,9.9,1746,34311,60556,14.2,13709,43775,69118,16.2,-8562,-2.0,21493,27075,6.2,5.9,28.4,Hawaii,1994
25521,344819,16801,4031,15.2,1713,2519,9.5,1702,43306,68827,20.0,9791,29065,45866,13.3,22961,6.7,23087,27136,7.4,4.9,26.6,Idaho,1994
244959,4674579,197026,27674,10.9,14986,22759,9.0,14934,467280,712239,15.2,95938,398277,595303,12.7,116936,2.5,209382,254937,5.2,4.2,25.4,Illinois,1994
112216,2233858,97635,13463,11.0,7190,10684,8.7,7144,223133,335349,15.0,41701,184433,282068,12.6,53281,2.4,98822,123919,5.0,4.4,25.2,Indiana,1994
49070,1054185,44435,6899,10.0,3893,5752,8.3,3879,97634,146704,13.9,20341,80470,124905,11.8,21799,2.1,56457,69542,4.7,4.2,23.6,Iowa,1994
51368,911281,40293,7055,11.5,3920,5763,9.4,3875,92372,143740,15.8,21570,73440,113733,12.5,30007,3.3,51161,62065,5.6,4.4,25.0,Kansas,1994
71825,1253328,53943,8584,11.5,4862,7037,9.4,4848,125422,197247,15.7,30478,108741,162684,13.0,34563,2.7,61120,75269,5.7,4.3,26.0,Kentucky,1994
83022,1324235,61101,10009,11.9,5452,8060,9.6,5422,143098,226120,17.1,34384,126679,187780,14.2,38340,2.9,68703,85118,6.3,4.6,28.4,Louisiana,1994
21311,405680,19396,3454,11.6,2007,2885,9.6,2003,41114,62425,15.4,11389,36937,56333,13.9,6092,1.5,25592,30119,5.3,4.8,27.8,Maine,1994
100420,1715818,88729,12274,11.7,6575,10447,10.0,6504,183284,283704,16.5,40183,171149,259878,15.1,23826,1.4,85659,105413,5.9,5.2,30.2,Maryland,1994
124243,2600319,117629,14973,10.9,8227,12678,9.2,8193,266446,390689,15.0,56955,247078,364707,14.0,25982,1.0,115026,138955,4.8,4.5,28.0,Massachusetts,1994
180540,3444715,163418,20743,10.7,11307,16779,8.7,11186,352359,532899,15.5,73811,283033,446451,13.0,86448,2.5,157355,194789,5.2,4.7,26.0,Michigan,1994
94187,1929655,79639,12103,11.4,5884,8942,8.4,5858,191082,285269,14.8,40071,152708,232347,12.0,52922,2.8,88527,107753,4.9,4.1,24.0,Minnesota,1994
62745,791400,36863,6016,12.1,3704,5173,10.4,3688,86608,149353,18.9,19477,63045,99908,12.6,49445,6.3,40993,50131,7.9,4.7,25.2,Mississippi,1994
109709,2035599,92012,14935,12.3,8322,12102,10.0,8293,209556,319265,15.7,49093,168902,260914,12.8,58351,2.9,100222,122714,5.4,4.5,25.6,Missouri,1994
15227,244093,12682,3088,13.0,1615,2292,9.6,1615,24591,39818,16.3,7487,24687,37369,15.3,2449,1.0,20871,24169,6.2,5.2,30.6,Montana,1994
33018,620506,27913,4384,10.6,2429,3548,8.6,2421,58728,91746,14.8,13544,47630,75543,12.2,16203,2.6,34734,41715,5.3,4.5,24.4,Nebraska,1994
47095,594536,34195,5006,16.9,2304,3372,11.4,2298,85183,132278,22.2,22040,46847,81042,13.6,51236,8.6,25550,30321,7.9,5.8,27.2,Nevada,1994
24228,428459,19791,3642,12.5,1923,2896,10.0,1922,47905,72133,16.8,9644,33632,53423,12.5,18710,4.3,24930,29374,5.7,4.6,25.0,New Hampshire,1994
166225,3059172,158587,21358,11.4,12337,18728,10.0,12256,299476,465701,15.2,77345,298836,457423,15.0,8278,0.2,161132,188124,5.4,5.2,30.0,New Jersey,1994
33715,459751,25703,4758,13.8,2497,3581,10.4,2489,54612,88327,19.2,14218,42473,68176,14.8,20151,4.4,29254,34918,7.3,5.6,29.6,New Mexico,1994
337489,6575682,319700,45895,11.4,30566,43644,10.8,30401,623601,961090,14.6,176252,649638,969338,14.7,-8248,-0.1,346091,404479,5.1,4.9,29.2,New York,1994
154076,2752790,110356,18552,12.0,9514,13896,9.0,9470,279300,433376,15.7,58547,214144,324500,11.8,108876,3.9,124616,156906,5.6,4.0,23.6,North Carolina,1994
9451,214997,7487,1747,9.9,980,1437,8.2,978,21169,30620,14.2,4376,16863,24350,11.3,6270,2.9,14999,17739,4.4,3.5,22.6,North Dakota,1994
222206,4273013,171797,24152,10.5,12805,19761,8.6,12673,416843,639049,15.0,77492,362842,534639,12.5,104410,2.5,182111,232762,5.2,4.0,25.0,Ohio,1994
57988,985381,47902,8687,12.3,4911,6913,9.8,4906,100754,158742,16.1,27235,90305,138207,14.0,20535,2.1,59055,71479,5.9,4.9,28.0,Oklahoma,1994
74720,1080056,51367,11027,14.2,5084,7610,9.8,5071,122952,197672,18.3,26370,91302,142669,13.2,55003,5.1,66290,79009,6.9,4.8,26.4,Oregon,1994
219667,4500087,206850,23743,9.4,14995,22356,8.8,14883,406953,626620,13.9,100223,393320,600170,13.3,26450,0.6,204123,253624,4.9,4.6,26.6,Pennsylvania,1994
21981,369123,19637,2666,11.2,1605,2385,10.0,1601,31369,53350,14.5,9608,40436,60073,16.3,-6723,-1.8,21332,23939,6.0,5.3,29.0,Rhode Island,1994
84016,1295372,61326,9211,12.2,5059,7440,9.9,5042,127979,211995,16.4,32212,106686,168012,13.0,43983,3.4,60991,76229,6.5,4.7,26.0,South Carolina,1994
15416,248034,11968,2288,11.8,1178,1685,8.7,1175,24591,40007,16.1,7284,19539,31507,12.7,8500,3.4,16860,19622,6.2,4.8,25.4,South Dakota,1994
122031,1974443,96074,12984,12.1,6955,10231,9.5,6919,199078,321109,16.3,45748,162699,258773,13.1,62336,3.2,86567,108939,6.2,4.9,26.2,Tennessee,1994
432105,6221921,347802,50661,13.5,27054,40123,10.7,26915,688167,1120272,18.0,172658,641411,989213,15.9,131059,2.1,297469,380583,6.9,5.6,31.8,Texas,1994
47354,668105,34331,5781,15.9,2622,3802,10.4,2613,80777,128131,19.2,19701,51936,86267,12.9,41864,6.3,31010,37419,7.1,5.1,25.8,Utah,1994
9996,215493,9178,1922,10.9,1087,1583,9.0,1082,20098,30094,14.0,4970,17024,26202,12.2,3892,1.8,15671,17725,4.6,4.3,24.4,Vermont,1994
135017,2363292,104294,16525,11.9,8400,13195,9.5,8361,236694,371711,15.7,46036,306761,411055,17.4,-39344,-1.7,110799,140918,5.7,4.4,31.4,Virginia,1994
113646,1843105,87998,17889,14.1,9150,13678,10.7,9127,196688,310334,16.8,48116,189502,277500,15.1,32834,1.7,107728,129097,6.2,4.8,30.2,Washington,1994
27317,492295,21064,3863,10.9,1987,2961,8.4,1982,49053,76370,15.5,10466,43217,64281,13.1,12089,2.4,29426,35811,5.5,4.3,26.2,West Virginia,1994
94337,2049898,69270,11975,10.3,6604,9661,8.3,6566,183119,277456,13.5,38191,157547,226817,11.1,50639,2.4,96234,116838,4.6,3.4,22.2,Wisconsin,1994
10682,143943,6685,1862,13.2,851,1260,8.9,849,16201,26883,18.7,4112,13515,20200,14.0,6683,4.7,12355,14366,7.4,4.6,28.0,Wyoming,1994
86798,1467007,60000,10622,12.5,5705,8166,9.6,5662,164031,250829,17.1,33571,114755,174755,11.9,76074,5.2,68976,85909,5.9,4.1,23.8,Alabama,1995
11715,172692,8862,1882,13.5,952,1472,10.5,943,19419,31134,18.0,4957,18935,27797,16.1,3337,1.9,11847,14143,6.8,5.1,32.2,Alaska,1995
114600,1432500,74201,12940,15.2,6540,9572,11.2,6436,180298,294898,20.6,41490,126209,200410,14.0,94488,6.6,70159,86610,8.0,5.2,28.0,Arizona,1995
50414,852651,41891,6889,13.1,3754,5251,10.0,3749,95796,146210,17.1,23336,59964,101855,11.9,44355,5.2,44595,53484,5.9,4.9,23.8,Arkansas,1995
667725,10614063,561589,82358,12.7,49295,73802,11.4,48884,1214349,1882074,17.7,295961,1006334,1567923,14.8,314151,2.9,526482,648641,6.3,5.3,29.6,California,1995
119087,1478714,74051,15212,15.3,6988,10433,10.5,6966,179259,298346,20.2,42727,135302,209353,14.2,88993,6.0,85450,101591,8.1,5.0,28.4,Colorado,1995
73542,1383830,56813,8641,10.7,4839,7346,9.1,4784,123492,197034,14.2,25884,122203,179016,12.9,18018,1.3,68746,81012,5.3,4.1,25.8,Connecticut,1995
17283,314074,13275,2319,13.0,1092,1724,9.7,1087,38797,56080,17.9,6034,24397,37672,12.0,18408,5.9,15180,18141,5.5,4.2,24.0,Delaware,1995
17561,407790,17520,1801,10.2,929,1653,9.3,923,39439,57000,14.0,7438,39419,56939,14.0,61,0.0,14755,17774,4.3,4.3,28.0,District of Columbia,1995
416656,5010695,308071,49651,14.5,29457,41223,12.0,29295,588949,1005605,20.1,180357,479225,787296,15.7,218309,4.4,283724,346872,8.3,6.1,31.4,Florida,1995
211358,2770099,140209,21751,14.1,10585,15910,10.3,10532,326434,537792,19.4,71666,223038,363247,13.1,174545,6.3,124444,156989,7.6,5.1,26.2,Geogia,1995
25371,421647,18763,2864,10.6,1796,2637,9.7,1787,32366,57737,13.7,8445,37783,56546,13.4,1191,0.3,21547,27194,6.0,4.4,26.8,Hawaii,1995
24536,361497,21718,3978,14.4,1939,2862,10.4,1934,40548,65084,18.0,9114,30568,52286,14.5,12798,3.5,24017,28116,6.8,6.0,29.0,Idaho,1995
256602,4800455,197813,28881,11.2,15104,23320,9.1,15017,487428,744030,15.5,97424,405510,603323,12.6,140707,2.9,213113,259721,5.3,4.1,25.2,Illinois,1995
126697,2311145,85301,14422,11.5,7522,11140,8.9,7490,239852,366549,15.9,43487,178947,264248,11.4,102301,4.5,100740,126812,5.5,3.7,22.8,Indiana,1995
54375,1086338,43338,7122,10.2,4059,5962,8.5,4045,106115,160490,14.8,20812,72288,115626,10.6,44864,4.2,57097,70481,5.0,4.0,21.2,Iowa,1995
50866,940378,37831,7112,11.4,4007,5787,9.2,3984,89007,139873,14.9,20646,70963,108794,11.6,31079,3.3,52006,63151,5.4,4.0,23.2,Kansas,1995
76903,1296623,58104,8909,11.7,4900,7091,9.3,4880,136186,213089,16.4,30133,100684,158788,12.2,54301,4.2,62220,76787,5.9,4.5,24.4,Kentucky,1995
93466,1363101,76292,9912,11.6,5540,8178,9.5,5486,150414,243880,17.9,38899,121768,198060,14.5,45820,3.4,69816,86523,6.9,5.6,29.0,Louisiana,1995
21243,414733,17044,3646,12.0,2015,2980,9.8,2010,41320,62563,15.1,9920,33004,50048,12.1,12515,3.0,26167,30688,5.1,4.1,24.2,Maine,1995
104957,1762752,81931,13076,12.3,6809,10474,9.8,6763,194488,299445,17.0,40782,142823,224754,12.8,74691,4.2,87612,107686,6.0,4.6,25.6,Maryland,1995
135246,2650051,112220,16085,11.5,8279,12878,9.2,8204,271749,406995,15.4,54833,218439,330659,12.5,76336,2.9,117390,141833,5.1,4.2,25.0,Massachusetts,1995
210096,3569755,144992,22284,11.3,11415,17149,8.7,11363,387444,597540,16.7,72549,283342,428334,12.0,169206,4.7,161096,199288,5.9,4.1,24.0,Michigan,1995
118805,1999258,74186,12156,11.2,6108,9487,8.7,6068,194194,312999,15.7,40151,146217,220403,11.0,92596,4.7,90383,109932,5.9,3.7,22.0,Minnesota,1995
58406,831653,40151,6227,12.3,3525,5015,9.9,3518,86364,144770,17.4,22708,71615,111766,13.4,33004,4.0,41773,51152,7.0,4.8,26.8,Mississippi,1995
118156,2098938,93501,15006,12.1,8437,12286,9.9,8397,223459,341615,16.3,47136,174441,267942,12.8,73673,3.5,101932,124894,5.6,4.5,25.6,Missouri,1995
17622,250389,12724,3317,13.5,1730,2393,9.8,1727,25886,43508,17.4,8467,19174,31898,12.7,11610,4.7,21493,24898,7.0,5.1,25.4,Montana,1995
31771,642471,24008,4256,10.1,2455,3555,8.5,2445,65808,97579,15.2,12227,44138,68146,10.6,29433,4.6,35077,42237,4.9,3.7,21.2,Nebraska,1995
53865,640958,29020,5405,17.4,2523,3626,11.7,2518,71667,125532,19.6,17854,52573,81593,12.7,43939,6.9,26897,31949,8.4,4.5,25.4,Nevada,1995
30385,448680,20118,3843,12.9,1907,2870,9.6,1901,45432,75817,16.9,10675,33492,53610,11.9,22207,5.0,25726,30296,6.8,4.5,23.8,New Hampshire,1995
172419,3100003,145942,23192,12.2,12338,18330,9.6,12236,315791,488210,15.7,70479,265182,411124,13.3,77086,2.4,165141,192419,5.6,4.7,26.6,New Jersey,1995
33996,479681,26717,4802,13.6,2615,3798,10.8,2603,54257,88253,18.4,14310,39874,66591,13.9,21662,4.5,29917,35712,7.1,5.6,27.8,New Mexico,1995
354752,6616828,293126,47664,11.7,29371,41866,10.3,29255,642421,997173,15.1,160425,613554,906680,13.7,90493,1.4,350203,409210,5.4,4.4,27.4,New York,1995
161002,2876894,110097,19740,12.4,9717,14259,8.9,9687,296803,457805,15.9,56778,212275,322372,11.2,135433,4.7,128770,161947,5.6,3.8,22.4,North Carolina,1995
10926,222130,8829,1745,9.8,949,1409,7.9,943,23266,34192,15.4,4808,15620,24449,11.0,9743,4.4,15221,17983,4.9,4.0,22.0,North Dakota,1995
226608,4403850,162545,24995,10.6,12973,20059,8.5,12872,442464,669072,15.2,79237,337863,500408,11.4,168664,3.8,185483,236995,5.1,3.7,22.8,Ohio,1995
59557,1008427,51323,8568,11.9,5191,7291,10.1,5174,104536,164093,16.3,27134,84709,136032,13.5,28061,2.8,59817,72460,5.9,5.1,27.0,Oklahoma,1995
77017,1132074,53724,11212,14.0,5716,8514,10.6,5654,130604,207621,18.3,30651,96146,149870,13.2,57751,5.1,68413,81318,6.8,4.7,26.4,Oregon,1995
225485,4570932,182141,25863,10.1,14219,21523,8.4,14146,429033,654518,14.3,91494,343312,525453,11.5,129065,2.8,206887,257102,4.9,4.0,23.0,Pennsylvania,1995
19387,371131,14181,2669,11.1,1560,2273,9.4,1552,36049,55436,14.9,7546,29955,44136,11.9,11300,3.0,21548,24250,5.2,3.8,23.8,Rhode Island,1995
82476,1342742,60129,9858,12.8,5177,7569,9.8,5147,134191,216667,16.1,30319,104070,164199,12.2,52468,3.9,62675,78274,6.1,4.5,24.4,South Carolina,1995
12469,258190,10350,2127,10.7,1164,1669,8.4,1163,26356,38825,15.0,5405,15888,26238,10.2,12587,4.8,17171,19969,4.8,4.0,20.4,South Dakota,1995
125622,2071888,82241,13707,12.4,7139,10474,9.5,7087,246907,372529,18.0,43354,160540,242781,11.7,129748,6.3,88817,111848,6.1,4.0,23.4,Tennessee,1995
477202,6437669,337018,51671,13.4,28005,41292,10.7,27732,760485,1237687,19.2,180751,589451,926469,14.4,311218,4.8,304034,389147,7.4,5.2,28.8,Texas,1995
54216,710460,33768,5943,15.5,2777,4039,10.6,2763,84917,139133,19.6,20254,59602,93370,13.1,45763,6.5,32474,39149,7.6,4.8,26.2,Utah,1995
10775,219517,11567,1927,10.8,1140,1609,9.0,1139,21850,32625,14.9,6263,16453,28020,12.8,4605,2.1,15904,17980,4.9,5.3,25.6,Vermont,1995
144859,2385108,107636,17546,12.3,8755,13532,9.5,8710,250679,395538,16.6,49887,193756,301392,12.6,94146,4.0,113851,144500,6.1,4.5,25.2,Virginia,1995
123155,1885068,97854,18020,13.8,10012,14691,11.3,9931,197005,320160,17.0,56470,168647,266501,14.1,53659,2.9,109793,131600,6.5,5.2,28.2,Washington,1995
29326,507859,24236,4161,11.5,2166,3257,9.0,2163,53046,82372,16.2,11015,38509,62745,12.4,19627,3.8,30050,36575,5.8,4.8,24.8,West Virginia,1995
93956,2111438,70291,12225,10.4,6876,9979,8.5,6766,198418,292374,13.8,39606,145888,216179,10.2,76195,3.6,97668,118674,4.4,3.3,20.4,Wisconsin,1995
10259,150101,7887,1802,12.4,956,1400,9.6,955,16076,26335,17.5,4198,13682,21569,14.4,4766,3.1,12678,14691,6.8,5.3,28.8,Wyoming,1995
89766,1517840,72132,10721,12.4,6118,8773,10.1,6118,148711,238477,15.7,37078,142799,214931,14.2,23546,1.5,70247,87659,5.9,4.8,28.4,Alabama,1996
9714,175631,10869,1859,13.0,930,1522,10.7,930,20558,30272,17.2,4441,16471,27340,15.6,2932,1.6,12128,14441,5.5,6.2,31.2,Alaska,1996
115988,1519275,79970,13178,15.0,6652,9998,11.4,6651,180551,296539,19.5,43090,134880,214850,14.1,81689,5.4,72373,89522,7.6,5.3,28.2,Arizona,1996
47090,882467,37309,6695,12.4,4007,5674,10.5,4006,84657,131747,14.9,21723,77648,114957,13.0,16790,1.9,45282,54317,5.3,4.2,26.0,Arkansas,1996
684629,10867543,671559,83444,12.8,48266,73535,11.3,48254,1252449,1937078,17.8,308558,1093867,1765426,16.2,171652,1.6,533916,656141,6.3,6.2,32.4,California,1996
129590,1548413,103176,15075,14.6,7652,11757,11.4,7651,176133,305723,19.7,44769,152575,255751,16.5,49972,3.2,88173,104559,8.4,6.7,33.0,Colorado,1996
81487,1403573,61224,8146,10.0,4853,7614,9.4,4852,122976,204463,14.6,28897,125981,187205,13.3,17258,1.3,69027,81409,5.8,4.4,26.6,Connecticut,1996
18331,323605,17100,2211,12.1,1118,1854,10.1,1118,30013,48344,14.9,6933,30941,48041,14.8,303,0.1,15567,18533,5.7,5.3,29.6,Delaware,1996
16730,397889,16806,1844,10.3,944,1689,9.5,944,31983,48713,12.2,5785,50678,67484,17.0,-18771,-4.8,14897,17886,4.2,4.2,24.4,District of Columbia,1996
423981,5192648,340929,49338,14.1,29228,42164,12.1,29226,600378,1024359,19.7,186712,533598,874527,16.8,149832,2.9,288960,352893,8.2,6.6,33.6,Florida,1996
209521,2903831,174934,22432,14.1,11271,17505,11.0,11270,325793,535314,18.4,76178,271083,446017,15.4,89297,3.0,128308,161583,7.2,6.0,30.8,Geogia,1996
27470,422490,20565,2801,10.3,1776,2835,10.5,1776,33461,60931,14.4,9072,41744,62309,14.7,-1378,-0.3,21499,27072,6.5,4.9,28.8,Hawaii,1996
27110,373127,21906,4159,14.6,2126,3086,10.8,2126,42944,70054,18.8,12482,36708,58614,15.7,11440,3.1,24803,29029,7.3,5.9,31.4,Idaho,1996
262148,4902424,206542,28857,11.0,15941,25080,9.6,15940,465697,727845,14.8,93439,462873,669415,13.7,58430,1.1,215915,263187,5.3,4.2,27.4,Illinois,1996
128150,2376361,117631,14091,11.0,7965,12293,9.6,7964,217351,345501,14.5,48956,217864,335495,14.1,10006,0.4,102077,128389,5.4,5.0,28.2,Indiana,1996
56230,1124169,40846,6862,9.7,4023,6092,8.6,4022,100426,156656,13.9,20974,87028,127874,11.4,28782,2.5,57677,71152,5.0,3.6,22.8,Iowa,1996
57232,972447,44893,7189,11.3,4163,6071,9.5,4163,94785,152017,15.6,24401,77533,122426,12.6,29591,3.0,52766,64136,5.9,4.6,25.2,Kansas,1996
83980,1335854,61280,8805,11.4,5145,7522,9.7,5145,121759,205739,15.4,31797,125458,186738,14.0,19001,1.4,62919,77957,6.3,4.6,28.0,Kentucky,1996
80314,1407156,62986,9777,11.2,5339,7860,9.0,5338,153351,233665,16.6,33637,130605,193591,13.8,40074,2.8,71286,88202,5.7,4.5,27.6,Louisiana,1996
22973,423512,18874,3807,12.3,2123,3033,9.8,2123,36101,59074,13.9,10892,36448,55322,13.1,3752,0.8,26748,31348,5.4,4.5,26.2,Maine,1996
108941,1801753,96172,12346,11.4,7012,11091,10.3,7007,174636,283577,15.7,43985,182801,278973,15.5,4604,0.2,88572,108677,6.0,5.3,31.0,Maryland,1996
129224,2708174,135486,15313,10.7,8330,13184,9.2,8329,264650,393874,14.5,57694,221496,356982,13.2,36892,1.3,119062,143754,4.8,5.0,26.4,Massachusetts,1996
182944,3676047,149146,22098,11.0,11828,17827,8.9,11828,347334,530278,14.4,76617,342533,491679,13.4,38599,1.0,164295,203279,5.0,4.1,26.8,Michigan,1996
109205,2070519,78954,12516,11.3,6269,9804,8.8,6267,191681,300886,14.5,41788,181526,260480,12.6,40406,1.9,92887,112583,5.3,3.8,25.2,Minnesota,1996
56494,853164,44819,6295,12.2,3705,5359,10.4,3705,78117,134611,15.8,22072,79631,124450,14.6,10161,1.2,42269,51929,6.6,5.3,29.2,Mississippi,1996
122184,2158053,99682,14497,11.5,8556,12457,9.9,8556,211430,333614,15.5,48704,194741,294423,13.6,39191,1.9,103215,126733,5.7,4.6,27.2,Missouri,1996
17483,258988,14290,3290,13.1,1746,2689,10.7,1746,24935,42418,16.4,8261,22675,36965,14.3,5453,2.1,22079,25378,6.8,5.5,28.6,Montana,1996
35437,671920,24978,4267,10.1,2617,3840,9.1,2617,62127,97564,14.5,13617,51307,76285,11.4,21279,3.1,35321,42573,5.3,3.7,22.8,Nebraska,1996
65304,683539,41433,5563,17.1,2720,4067,12.5,2720,79290,144594,21.2,20800,61429,102862,15.0,41732,6.2,27947,33304,9.6,6.1,30.0,Nevada,1996
26268,468910,20026,3888,12.7,1940,2977,9.7,1939,48614,74882,16.0,10861,36939,56965,12.1,17917,3.9,26469,31128,5.6,4.3,24.2,New Hampshire,1996
182341,3151479,163457,22753,11.7,13290,19861,10.3,13287,312443,494784,15.7,71341,308336,471793,15.0,22991,0.7,167550,194970,5.8,5.2,30.0,New Jersey,1996
